Date,Country,Total_Confirmed_Cases,total_vaccinations_per_hundred,GDP(USD),Current_positive_cases,Total_Deaths,Total_Recovered
1/2/21,Bulgaria,219580,0.62,8900,30608,9142,188972
2/2/21,Bulgaria,220547,0.67,8900,30063,9178,190484
3/2/21,Bulgaria,221266,0.73,8900,29714,9218,191552
4/2/21,Bulgaria,222149,0.78,8900,29817,9272,192332
5/2/21,Bulgaria,223059,0.82,8900,30029,9302,193030
6/2/21,Bulgaria,223552,0.83,8900,30361,9311,193191
7/2/21,Bulgaria,223734,0.83,8900,30483,9331,193251
8/2/21,Bulgaria,224849,0.85,8900,30794,9420,194055
9/2/21,Bulgaria,226061,0.91,8900,31547,9482,194514
10/2/21,Bulgaria,226974,0.96,8900,31763,9527,195211
11/2/21,Bulgaria,228044,1.03,8900,32362,9561,195682
12/2/21,Bulgaria,229010,1.08,8900,32806,9594,196204
13/2/21,Bulgaria,229516,1.09,8900,32923,9608,196593
14/2/21,Bulgaria,229679,1.09,8900,32759,9624,196920
15/2/21,Bulgaria,230747,1.12,8900,33171,9671,197576
16/2/21,Bulgaria,232096,1.18,8900,33772,9703,198324
17/2/21,Bulgaria,233342,1.25,8900,34454,9744,198888
18/2/21,Bulgaria,234428,1.31,8900,34796,9786,199632
19/2/21,Bulgaria,235891,1.51,8900,35913,9821,199978
20/2/21,Bulgaria,236439,1.57,8900,36301,9839,200138
21/2/21,Bulgaria,236666,1.73,8900,36414,9854,200252
22/2/21,Bulgaria,238591,1.9,8900,37562,9933,201029
23/2/21,Bulgaria,240391,2.15,8900,38891,9978,201500
24/2/21,Bulgaria,242124,2.44,8900,40119,10026,202005
25/2/21,Bulgaria,243946,2.73,8900,41252,10079,202694
26/2/21,Bulgaria,245627,2.96,8900,42133,10128,203494
27/2/21,Bulgaria,246706,3.04,8900,41569,10167,205137
28/2/21,Bulgaria,247038,3.08,8900,41493,10191,205545
1/3/21,Bulgaria,249626,3.24,8900,42996,10308,206630
2/3/21,Bulgaria,252029,3.53,8900,43618,10391,208411
3/3/21,Bulgaria,253183,3.6,8900,44183,10413,209000
4/3/21,Bulgaria,255381,3.89,8900,44743,10506,210638
5/3/21,Bulgaria,258385,4.12,8900,46467,10571,211918
6/3/21,Bulgaria,259811,4.16,8900,47309,10593,212502
7/3/21,Bulgaria,260308,4.19,8900,47421,10614,212887
8/3/21,Bulgaria,263303,4.26,8900,49188,10764,214115
9/3/21,Bulgaria,266805,4.38,8900,49287,10902,217518
10/3/21,Bulgaria,269579,4.48,8900,49530,10999,220049
11/3/21,Bulgaria,272700,4.7,8900,50917,11094,221783
12/3/21,Bulgaria,275859,4.88,8900,52379,11196,223480
13/3/21,Bulgaria,277878,4.9,8900,53280,11234,224598
14/3/21,Bulgaria,278557,4.91,8900,53375,11285,225182
15/3/21,Bulgaria,283194,4.95,8900,56135,11472,227059
16/3/21,Bulgaria,287568,5.02,8900,58752,11579,228816
17/3/21,Bulgaria,291769,5.09,8900,61312,11715,230457
18/3/21,Bulgaria,295777,5.16,8900,63736,11817,232041
19/3/21,Bulgaria,299939,5.26,8900,66343,11932,233596
20/3/21,Bulgaria,302480,5.31,8900,68243,11966,234237
21/3/21,Bulgaria,303423,5.35,8900,68652,12019,234771
22/3/21,Bulgaria,307890,5.46,8900,70859,12188,237031
23/3/21,Bulgaria,312741,5.64,8900,73139,12307,239602
24/3/21,Bulgaria,317116,5.82,8900,74805,12413,242311
25/3/21,Bulgaria,321104,6.03,8900,76632,12512,244472
26/3/21,Bulgaria,325233,6.24,8900,77782,12601,247451
27/3/21,Bulgaria,327770,6.3,8900,78866,12650,248904
28/3/21,Bulgaria,328753,6.33,8900,79392,12710,249361
29/3/21,Bulgaria,333250,6.46,8900,80777,12913,252473
30/3/21,Bulgaria,338426,6.65,8900,82734,13068,255692
31/3/21,Bulgaria,342633,6.85,8900,83072,13197,259561
1/4/21,Bulgaria,346327,7.05,8900,84232,13313,262095
2/4/21,Bulgaria,350340,7.22,8900,84249,13438,266091
3/4/21,Bulgaria,352259,7.28,8900,82684,13507,269575
4/4/21,Bulgaria,352999,7.3,8900,82566,13589,270433
5/4/21,Bulgaria,356859,7.4,8900,83430,13786,273429
6/4/21,Bulgaria,356859,7.53,8900,83430,13786,273429
7/4/21,Bulgaria,364419,7.73,8900,85754,14034,278665
8/4/21,Bulgaria,367376,8.01,8900,85397,14170,281979
9/4/21,Bulgaria,370179,8.23,8900,85310,14308,284869
10/4/21,Bulgaria,371531,8.28,8900,85732,14351,285799
11/4/21,Bulgaria,371993,8.3,8900,85735,14418,286258
12/4/21,Bulgaria,375115,8.41,8900,85759,14619,289356
13/4/21,Bulgaria,378059,8.56,8900,84708,14746,293351
14/4/21,Bulgaria,380576,8.78,8900,83578,14871,296998
15/4/21,Bulgaria,382761,9,8900,82370,14979,300391
16/4/21,Bulgaria,384887,9.19,8900,80854,15100,304033
17/4/21,Bulgaria,385963,9.24,8900,80726,15138,305237
18/4/21,Bulgaria,386381,9.26,8900,79703,15195,306678
19/4/21,Bulgaria,388815,9.36,8900,77893,15412,310922
20/4/21,Bulgaria,390911,9.53,8900,76638,15518,314273
21/4/21,Bulgaria,392913,9.81,8900,74705,15618,318208
22/4/21,Bulgaria,392913,10.13,8900,74705,15618,318208
23/4/21,Bulgaria,396302,10.4,8900,72425,15826,323877
24/4/21,Bulgaria,397100,10.46,8900,72714,15859,324386
25/4/21,Bulgaria,397500,10.49,8900,72557,15907,324943
26/4/21,Bulgaria,399259,10.65,8900,70216,16101,329043
27/4/21,Bulgaria,401109,10.89,8900,68691,16182,332418
28/4/21,Bulgaria,402491,11.26,8900,67060,16278,335431
29/4/21,Bulgaria,403728,11.65,8900,65416,16368,338312
30/4/21,Bulgaria,404380,11.82,8900,64846,16399,339534
1/5/21,Bulgaria,404846,11.91,8900,64957,16444,339889
2/5/21,Bulgaria,405194,11.96,8900,64752,16492,340442
3/5/21,Bulgaria,405825,12.09,8900,64657,16548,341168
4/5/21,Bulgaria,406192,12.25,8900,63966,16609,342226
5/5/21,Bulgaria,407827,12.72,8900,62932,16773,344895
6/5/21,Bulgaria,408372,12.82,8900,62883,16800,345489
7/5/21,Bulgaria,409495,13.37,8900,61625,16886,347870
8/5/21,Bulgaria,409961,13.52,8900,61776,16902,348185
9/5/21,Bulgaria,410202,13.6,8900,61810,16929,348392
10/5/21,Bulgaria,411280,13.97,8900,59883,17045,351397
11/5/21,Bulgaria,412157,14.49,8900,58538,17104,353619
12/5/21,Bulgaria,412814,15.02,8900,55665,17150,357149
13/5/21,Bulgaria,413320,15.57,8900,53318,17194,360002
14/5/21,Bulgaria,413838,16.05,8900,51845,17243,361993
15/5/21,Bulgaria,414041,16.14,8900,51714,17250,362327
16/5/21,Bulgaria,414192,16.19,8900,51717,17259,362475
17/5/21,Bulgaria,414869,16.46,8900,50187,17343,364682
18/5/21,Bulgaria,415326,16.83,8900,47862,17379,367464
19/5/21,Bulgaria,415687,17.27,8900,45906,17416,369781
20/5/21,Bulgaria,416055,17.77,8900,44500,17447,371555
21/5/21,Bulgaria,416417,18.13,8900,43449,17474,372968
22/5/21,Bulgaria,416565,18.23,8900,43363,17487,373202
23/5/21,Bulgaria,416646,18.28,8900,43261,17496,373385
24/5/21,Bulgaria,416727,18.35,8900,43024,17513,373703
25/5/21,Bulgaria,417133,18.6,8900,41007,17581,376126
26/5/21,Bulgaria,417526,18.9,8900,40208,17617,377318
27/5/21,Bulgaria,417819,19.17,8900,38663,17637,379156
28/5/21,Bulgaria,418106,19.45,8900,37852,17652,380254
29/5/21,Bulgaria,418221,19.55,8900,37862,17657,380359
30/5/21,Bulgaria,418274,19.62,8900,37737,17662,380537
31/5/21,Bulgaria,418577,19.81,8900,36394,17700,382183
1/6/21,Bulgaria,418813,20.07,8900,35048,17726,383765
2/6/21,Bulgaria,419010,20.39,8900,34233,17747,384777
3/6/21,Bulgaria,419180,20.72,8900,33909,17792,385271
4/6/21,Bulgaria,419337,21.04,8900,33406,17810,385931
5/6/21,Bulgaria,419426,21.12,8900,33358,17813,386068
6/6/21,Bulgaria,419473,21.23,8900,33374,17820,386099
7/6/21,Bulgaria,419681,21.44,8900,32988,17854,386693
8/6/21,Bulgaria,419859,21.76,8900,32443,17860,387416
9/6/21,Bulgaria,419990,22.11,8900,32075,17872,387915
10/6/21,Bulgaria,420090,22.45,8900,31505,17887,388585
11/6/21,Bulgaria,420213,22.75,8900,30845,17893,389368
12/6/21,Bulgaria,420294,22.82,8900,30892,17898,389402
13/6/21,Bulgaria,420336,22.87,8900,30841,17900,389495
14/6/21,Bulgaria,420493,23.01,8900,30105,17915,390388
15/6/21,Bulgaria,420654,23.23,8900,29683,17932,390971
16/6/21,Bulgaria,420749,23.49,8900,28714,17957,392035
17/6/21,Bulgaria,420859,23.75,8900,28407,17980,392452
18/6/21,Bulgaria,420964,23.97,8900,28192,17987,392772
19/6/21,Bulgaria,421005,24.03,8900,28196,17989,392809
20/6/21,Bulgaria,421032,24.07,8900,28216,17990,392816
21/6/21,Bulgaria,421152,24.2,8900,27966,18000,393186
22/6/21,Bulgaria,421246,24.38,8900,27610,18008,393636
23/6/21,Bulgaria,421339,24.58,8900,27469,18013,393870
24/6/21,Bulgaria,421401,24.79,8900,27453,18022,393948
25/6/21,Bulgaria,421487,24.97,8900,27396,18026,394091
26/6/21,Bulgaria,421515,25.01,8900,27409,18027,394106
27/6/21,Bulgaria,421531,25.05,8900,27406,18027,394125
28/6/21,Bulgaria,421646,25.17,8900,27404,18040,394242
29/6/21,Bulgaria,421751,25.35,8900,27282,18049,394469
30/6/21,Bulgaria,421829,25.54,8900,27172,18061,394657
1/2/21,Austria,415522,2.96,48105.36,21775,7778,393747
2/2/21,Austria,416763,3.15,48105.36,21447,7847,395316
3/2/21,Austria,418283,3.36,48105.36,21574,7902,396709
4/2/21,Austria,419801,3.59,48105.36,21891,7936,397910
5/2/21,Austria,421189,3.83,48105.36,21860,7973,399329
6/2/21,Austria,422522,3.93,48105.36,21671,7994,400851
7/2/21,Austria,423839,3.99,48105.36,21786,8012,402053
8/2/21,Austria,424896,4.1,48105.36,21594,8032,403302
9/2/21,Austria,426093,4.31,48105.36,21417,8071,404676
10/2/21,Austria,427562,4.56,48105.36,21641,8114,405921
11/2/21,Austria,429139,4.84,48105.36,21984,8138,407155
12/2/21,Austria,430870,5.14,48105.36,22444,8170,408426
13/2/21,Austria,432303,5.25,48105.36,22426,8195,409877
14/2/21,Austria,433487,5.28,48105.36,22288,8211,411199
15/2/21,Austria,434712,5.36,48105.36,22255,8221,412457
16/2/21,Austria,436139,5.52,48105.36,22231,8260,413908
17/2/21,Austria,437874,5.74,48105.36,22653,8290,415221
18/2/21,Austria,439841,5.96,48105.36,23410,8312,416431
19/2/21,Austria,441659,6.2,48105.36,24005,8348,417654
20/2/21,Austria,443536,6.34,48105.36,24253,8368,419283
21/2/21,Austria,445374,6.41,48105.36,24865,8386,420509
22/2/21,Austria,446644,6.49,48105.36,24833,8397,421811
23/2/21,Austria,448371,6.66,48105.36,25357,8434,423014
24/2/21,Austria,450376,6.88,48105.36,26028,8470,424348
25/2/21,Austria,452767,7.1,48105.36,26981,8493,425786
26/2/21,Austria,454860,7.43,48105.36,27603,8515,427257
27/2/21,Austria,457317,7.71,48105.36,28413,8538,428904
28/2/21,Austria,459440,7.82,48105.36,29025,8561,430415
1/3/21,Austria,460849,7.92,48105.36,28833,8574,432016
2/3/21,Austria,462769,8.21,48105.36,28896,8605,433873
3/3/21,Austria,465322,8.52,48105.36,29653,8625,435669
4/3/21,Austria,467646,8.83,48105.36,30444,8652,437202
5/3/21,Austria,470314,9.24,48105.36,31213,8669,439101
6/3/21,Austria,472871,9.55,48105.36,31562,8694,441309
7/3/21,Austria,475070,9.69,48105.36,31918,8713,443152
8/3/21,Austria,476980,9.82,48105.36,31948,8732,445032
9/3/21,Austria,479391,10.13,48105.36,32350,8757,447041
10/3/21,Austria,481919,10.46,48105.36,32866,8776,449053
11/3/21,Austria,484916,10.96,48105.36,34054,8798,450862
12/3/21,Austria,488042,11.61,48105.36,34964,8831,453078
13/3/21,Austria,491065,12.19,48105.36,35794,8856,455271
14/3/21,Austria,493568,12.54,48105.36,36302,8873,457266
15/3/21,Austria,495464,12.77,48105.36,36176,8892,459288
16/3/21,Austria,497889,13.09,48105.36,36230,8925,461659
17/3/21,Austria,501224,13.48,48105.36,37510,8956,463714
18/3/21,Austria,504581,13.87,48105.36,38597,8982,465984
19/3/21,Austria,508096,14.47,48105.36,39821,9024,468275
20/3/21,Austria,511440,15,48105.36,40756,9052,470684
21/3/21,Austria,514153,15.17,48105.36,40796,9074,473357
22/3/21,Austria,516565,15.35,48105.36,41338,9089,475227
23/3/21,Austria,519980,15.75,48105.36,42040,9121,477940
24/3/21,Austria,523269,16.2,48105.36,42672,9151,480597
25/3/21,Austria,526393,16.71,48105.36,42933,9178,483460
26/3/21,Austria,530288,17.28,48105.36,44200,9200,486088
27/3/21,Austria,533786,17.75,48105.36,44822,9231,488964
28/3/21,Austria,536465,17.91,48105.36,44846,9256,491619
29/3/21,Austria,539541,18.21,48105.36,45164,9275,494377
30/3/21,Austria,542542,18.67,48105.36,44726,9308,497816
31/3/21,Austria,546229,19.06,48105.36,45113,9339,501116
1/4/21,Austria,549592,19.53,48105.36,45863,9368,503729
2/4/21,Austria,552729,20.02,48105.36,46054,9397,506675
3/4/21,Austria,556012,20.27,48105.36,46462,9434,509550
4/4/21,Austria,558755,20.38,48105.36,46113,9449,512642
5/4/21,Austria,560972,20.52,48105.36,44888,9482,516084
6/4/21,Austria,562907,20.95,48105.36,43705,9517,519202
7/4/21,Austria,566008,21.57,48105.36,43234,9546,522774
8/4/21,Austria,568914,22.38,48105.36,43232,9586,525682
9/4/21,Austria,571616,23.26,48105.36,42425,9624,529191
10/4/21,Austria,574755,23.99,48105.36,42216,9662,532539
11/4/21,Austria,577007,24.28,48105.36,41209,9687,535798
12/4/21,Austria,578950,24.67,48105.36,40341,9706,538609
13/4/21,Austria,581263,25.17,48105.36,39477,9748,541786
14/4/21,Austria,584205,25.93,48105.36,39216,9779,544989
15/4/21,Austria,586883,26.76,48105.36,39279,9813,547604
16/4/21,Austria,589299,27.54,48105.36,38829,9843,550470
17/4/21,Austria,591347,28.19,48105.36,38728,9870,552619
18/4/21,Austria,593423,28.4,48105.36,38205,9898,555218
19/4/21,Austria,595540,28.76,48105.36,38073,9922,557467
20/4/21,Austria,597566,29.27,48105.36,37074,9959,560492
21/4/21,Austria,600089,29.97,48105.36,36833,9997,563256
22/4/21,Austria,602494,30.76,48105.36,36981,10026,565513
23/4/21,Austria,604823,31.53,48105.36,36610,10055,568213
24/4/21,Austria,606954,31.97,48105.36,36270,10070,570684
25/4/21,Austria,608979,32.28,48105.36,35824,10087,573155
26/4/21,Austria,610545,32.63,48105.36,35328,10098,575217
27/4/21,Austria,612170,33.17,48105.36,34193,10126,577977
28/4/21,Austria,614510,33.82,48105.36,34180,10152,580330
29/4/21,Austria,616739,34.67,48105.36,34164,10179,582575
30/4/21,Austria,618870,35.57,48105.36,34093,10205,584777
1/5/21,Austria,620485,36.04,48105.36,33370,10233,587115
2/5/21,Austria,622110,36.22,48105.36,32576,10245,589534
3/5/21,Austria,623201,36.55,48105.36,31676,10260,591525
4/5/21,Austria,624595,37.24,48105.36,30911,10291,593684
5/5/21,Austria,626239,38.11,48105.36,30362,10311,595877
6/5/21,Austria,627484,39.19,48105.36,29562,10333,597922
7/5/21,Austria,628817,40.41,48105.36,28963,10351,599854
8/5/21,Austria,630050,40.99,48105.36,28092,10374,601958
9/5/21,Austria,631076,41.2,48105.36,27175,10382,603901
10/5/21,Austria,631896,41.69,48105.36,26455,10392,605441
11/5/21,Austria,632766,42.43,48105.36,25054,10413,607712
12/5/21,Austria,633960,43.55,48105.36,24294,10428,609666
13/5/21,Austria,634893,43.93,48105.36,23639,10444,611254
14/5/21,Austria,635780,44.94,48105.36,23257,10455,612523
15/5/21,Austria,636424,45.61,48105.36,21621,10470,614803
16/5/21,Austria,637097,45.88,48105.36,20949,10474,616148
17/5/21,Austria,637573,46.41,48105.36,20266,10480,617307
18/5/21,Austria,638155,47.19,48105.36,19357,10499,618798
19/5/21,Austria,639054,48.37,48105.36,20256,10508,618798
20/5/21,Austria,639616,49.61,48105.36,19860,10527,619756
21/5/21,Austria,640293,50.85,48105.36,19456,10534,620837
22/5/21,Austria,640876,51.51,48105.36,18878,10541,621998
23/5/21,Austria,641380,51.84,48105.36,18491,10546,622889
24/5/21,Austria,641740,52.12,48105.36,18072,10547,623668
25/5/21,Austria,642138,52.73,48105.36,17589,10551,624549
26/5/21,Austria,642583,53.77,48105.36,17130,10566,625453
27/5/21,Austria,643168,54.88,48105.36,16909,10573,626259
28/5/21,Austria,643709,56.11,48105.36,16894,10588,626815
29/5/21,Austria,644207,56.8,48105.36,16535,10592,627672
30/5/21,Austria,644586,57.23,48105.36,16274,10596,628312
31/5/21,Austria,644815,57.72,48105.36,15959,10603,628856
1/6/21,Austria,645152,58.73,48105.36,15439,10615,629713
2/6/21,Austria,645552,60.33,48105.36,15278,10621,630274
3/6/21,Austria,645834,61.09,48105.36,15103,10627,630731
4/6/21,Austria,646167,62.31,48105.36,15029,10631,631138
5/6/21,Austria,646438,63.01,48105.36,15980,10636,630458
6/6/21,Austria,646800,63.61,48105.36,15858,10639,630942
7/6/21,Austria,647079,64.25,48105.36,15785,10640,631294
8/6/21,Austria,647322,65.27,48105.36,15453,10647,631869
9/6/21,Austria,647688,66.58,48105.36,15500,10650,632188
10/6/21,Austria,647971,67.93,48105.36,15311,10650,632660
11/6/21,Austria,648187,69.39,48105.36,15082,10652,633105
12/6/21,Austria,648387,70.16,48105.36,14849,10652,633538
13/6/21,Austria,648620,70.58,48105.36,14681,10661,633939
14/6/21,Austria,648732,71.12,48105.36,14609,10662,634123
15/6/21,Austria,648849,72.09,48105.36,14410,10668,634439
16/6/21,Austria,649002,73.43,48105.36,14102,10671,634900
17/6/21,Austria,649181,74.71,48105.36,13989,10674,635192
18/6/21,Austria,649309,75.96,48105.36,13765,10677,635544
19/6/21,Austria,649445,76.7,48105.36,13559,10679,635886
20/6/21,Austria,649576,77.12,48105.36,13451,10680,636125
21/6/21,Austria,649670,77.7,48105.36,13305,10680,636365
22/6/21,Austria,649728,78.72,48105.36,13205,10684,636523
23/6/21,Austria,649845,79.97,48105.36,13105,10686,636740
24/6/21,Austria,649922,81.19,48105.36,12999,10697,636923
25/6/21,Austria,650016,82.54,48105.36,12965,10700,637051
26/6/21,Austria,650192,83.4,48105.36,12954,10699,637238
27/6/21,Austria,650261,83.86,48105.36,12837,10700,637424
28/6/21,Austria,650324,84.43,48105.36,12779,10701,637545
29/6/21,Austria,650353,85.46,48105.36,12740,10700,637613
30/6/21,Austria,650412,86.73,48105.36,12661,10702,637751
1/2/21,Canada,788323,2.6,43241.62,70274,20145,718049
2/2/21,Canada,791385,2.63,43241.62,69383,20242,722002
3/2/21,Canada,794681,2.66,43241.62,68423,20361,726258
4/2/21,Canada,798650,2.72,43241.62,68882,20486,729768
5/2/21,Canada,802904,2.78,43241.62,76809,20607,726095
6/2/21,Canada,806010,2.83,43241.62,76639,20700,729371
7/2/21,Canada,808973,2.87,43241.62,76285,20760,732688
8/2/21,Canada,812700,2.93,43241.62,60310,20830,752390
9/2/21,Canada,815526,3,43241.62,58938,20914,756588
10/2/21,Canada,818967,3.08,43241.62,58491,21007,760476
11/2/21,Canada,822038,3.16,43241.62,58059,21089,763979
12/2/21,Canada,824754,3.26,43241.62,57584,21168,767170
13/2/21,Canada,828335,3.35,43241.62,59328,21238,769007
14/2/21,Canada,830352,3.39,43241.62,58396,21261,771956
15/2/21,Canada,832058,3.42,43241.62,57355,21298,774703
16/2/21,Canada,836455,3.49,43241.62,54305,21395,782150
17/2/21,Canada,838998,3.55,43241.62,53490,21439,785508
18/2/21,Canada,842393,3.62,43241.62,53285,21509,789108
19/2/21,Canada,845454,3.75,43241.62,52999,21581,792455
20/2/21,Canada,848060,3.89,43241.62,52609,21631,795451
21/2/21,Canada,850617,4,43241.62,52488,21675,798129
22/2/21,Canada,853901,4.16,43241.62,52223,21724,801678
23/2/21,Canada,857206,4.29,43241.62,51778,21763,805428
24/2/21,Canada,860200,4.41,43241.62,51751,21810,808449
25/2/21,Canada,863301,4.56,43241.62,51750,21868,811551
26/2/21,Canada,866528,4.75,43241.62,51969,21916,814559
27/2/21,Canada,869058,4.91,43241.62,52086,21961,816972
28/2/21,Canada,871243,5.03,43241.62,51823,21995,819420
1/3/21,Canada,874909,5.19,43241.62,51660,22018,823249
2/3/21,Canada,877747,5.38,43241.62,51575,22046,826172
3/3/21,Canada,880487,5.58,43241.62,51200,22106,829287
4/3/21,Canada,883619,5.79,43241.62,51535,22152,832084
5/3/21,Canada,886492,6.01,43241.62,51624,22193,834868
6/3/21,Canada,889255,6.21,43241.62,51525,22214,837730
7/3/21,Canada,891807,6.36,43241.62,51983,22240,839824
8/3/21,Canada,895889,6.58,43241.62,51988,22277,843901
9/3/21,Canada,898963,6.77,43241.62,52032,22305,846931
10/3/21,Canada,901948,6.98,43241.62,52164,22336,849784
11/3/21,Canada,905071,7.24,43241.62,52632,22372,852439
12/3/21,Canada,908645,7.53,43241.62,52796,22405,855849
13/3/21,Canada,911560,7.81,43241.62,53230,22435,858330
14/3/21,Canada,914204,8.06,43241.62,53425,22464,860779
15/3/21,Canada,917994,8.39,43241.62,53370,22496,864624
16/3/21,Canada,921011,8.7,43241.62,53469,22520,867542
17/3/21,Canada,924444,9.07,43241.62,53719,22555,870725
18/3/21,Canada,928117,9.48,43241.62,54502,22591,873615
19/3/21,Canada,932391,9.92,43241.62,55455,22618,876936
20/3/21,Canada,935714,10.27,43241.62,56197,22644,879517
21/3/21,Canada,938856,10.51,43241.62,56830,22677,882026
22/3/21,Canada,943715,10.89,43241.62,57606,22717,886109
23/3/21,Canada,947393,11.22,43241.62,58146,22736,889247
24/3/21,Canada,951589,11.67,43241.62,59388,22760,892201
25/3/21,Canada,956755,12.17,43241.62,61110,22791,895645
26/3/21,Canada,961839,12.75,43241.62,62609,22827,899230
27/3/21,Canada,966076,13.19,43241.62,64002,22853,902074
28/3/21,Canada,970166,13.57,43241.62,65257,22881,904909
29/3/21,Canada,976479,14.07,43241.62,66939,22901,909540
30/3/21,Canada,980365,14.51,43241.62,67681,22927,912684
31/3/21,Canada,989493,15.09,43241.62,70912,22960,918581
1/4/21,Canada,995249,15.64,43241.62,72617,23003,922632
2/4/21,Canada,998882,16.06,43241.62,74738,23032,924144
3/4/21,Canada,1005978,16.59,43241.62,76893,23051,929085
4/4/21,Canada,1009472,16.89,43241.62,78722,23075,930750
5/4/21,Canada,1017761,17.38,43241.62,80358,23096,937403
6/4/21,Canada,1028626,17.91,43241.62,83076,23142,945550
7/4/21,Canada,1036386,18.52,43241.62,85396,23174,950990
8/4/21,Canada,1044733,19.22,43241.62,88068,23212,956665
9/4/21,Canada,1053999,20.05,43241.62,91548,23252,962451
10/4/21,Canada,1061369,20.71,43241.62,94005,23288,967364
11/4/21,Canada,1069041,21.19,43241.62,96888,23316,972153
12/4/21,Canada,1079582,22.07,43241.62,99726,23357,979856
13/4/21,Canada,1087048,22.78,43241.62,100849,23393,986199
14/4/21,Canada,1096000,23.57,43241.62,103260,23446,992740
15/4/21,Canada,1105778,24.38,43241.62,106404,23501,999374
16/4/21,Canada,1115036,25.22,43241.62,108217,23542,1006819
17/4/21,Canada,1122116,25.89,43241.62,108583,23590,1013533
18/4/21,Canada,1130006,26.42,43241.62,109952,23624,1020054
19/4/21,Canada,1140322,27.11,43241.62,110108,23668,1030214
20/4/21,Canada,1147636,27.74,43241.62,109455,23714,1038181
21/4/21,Canada,1155855,28.58,43241.62,108886,23764,1046969
22/4/21,Canada,1164756,29.54,43241.62,107103,23823,1057653
23/4/21,Canada,1173220,30.51,43241.62,106481,23884,1066739
24/4/21,Canada,1180681,31.27,43241.62,106608,23928,1074073
25/4/21,Canada,1187484,31.88,43241.62,106444,23966,1081040
26/4/21,Canada,1196400,32.57,43241.62,105368,24025,1091032
27/4/21,Canada,1203429,33.25,43241.62,104296,24066,1099133
28/4/21,Canada,1211651,33.95,43241.62,104203,24118,1107448
29/4/21,Canada,1220914,34.75,43241.62,104020,24170,1116894
30/4/21,Canada,1229305,35.51,43241.62,104068,24220,1125237
1/5/21,Canada,1235669,36.13,43241.62,104175,24262,1131494
2/5/21,Canada,1241406,36.58,43241.62,104365,24301,1137041
3/5/21,Canada,1252391,37.18,43241.62,103798,24343,1148593
4/5/21,Canada,1259137,37.8,43241.62,102512,24400,1156625
5/5/21,Canada,1266916,38.55,43241.62,102490,24451,1164426
6/5/21,Canada,1275006,39.49,43241.62,102569,24490,1172437
7/5/21,Canada,1282734,40.55,43241.62,102603,24530,1180131
8/5/21,Canada,1288676,41.41,43241.62,102806,24569,1185870
9/5/21,Canada,1294120,42.13,43241.62,102640,24627,1191480
10/5/21,Canada,1302993,43.01,43241.62,101143,24683,1201850
11/5/21,Canada,1308541,43.8,43241.62,99219,24715,1209322
12/5/21,Canada,1315211,44.72,43241.62,98600,24769,1216611
13/5/21,Canada,1321104,45.76,43241.62,98008,24826,1223096
14/5/21,Canada,1327839,46.92,43241.62,95834,24870,1232005
15/5/21,Canada,1332229,47.88,43241.62,94453,24909,1237776
16/5/21,Canada,1336374,48.71,43241.62,93253,24949,1243121
17/5/21,Canada,1342824,49.74,43241.62,89815,24983,1253009
18/5/21,Canada,1346736,50.49,43241.62,86631,25019,1260105
19/5/21,Canada,1351766,51.43,43241.62,84691,25067,1267075
20/5/21,Canada,1356616,52.47,43241.62,83176,25112,1273440
21/5/21,Canada,1360950,53.76,43241.62,81101,25163,1279849
22/5/21,Canada,1364195,54.79,43241.62,80251,25204,1283944
23/5/21,Canada,1367023,55.61,43241.62,79238,25232,1287785
24/5/21,Canada,1368739,56.54,43241.62,75848,25262,1292891
25/5/21,Canada,1372492,57.21,43241.62,72212,25325,1300280
26/5/21,Canada,1374976,58.02,43241.62,69930,25362,1305046
27/5/21,Canada,1379674,59.09,43241.62,66071,25412,1313603
28/5/21,Canada,1382769,60.32,43241.62,64050,25441,1318719
29/5/21,Canada,1384928,61.23,43241.62,62326,25479,1322602
30/5/21,Canada,1386871,62.06,43241.62,60939,25513,1325932
31/5/21,Canada,1389814,63.09,43241.62,58293,25548,1331521
1/6/21,Canada,1391540,63.92,43241.62,55763,25567,1335777
2/6/21,Canada,1393732,64.83,43241.62,54215,25613,1339517
3/6/21,Canada,1395909,65.91,43241.62,53031,25645,1342878
4/6/21,Canada,1397898,67.13,43241.62,52054,25680,1345844
5/6/21,Canada,1399231,68.13,43241.62,51212,25713,1348019
6/6/21,Canada,1400580,68.98,43241.62,50302,25725,1350278
7/6/21,Canada,1402369,70.05,43241.62,48664,25762,1353705
8/6/21,Canada,1403490,70.99,43241.62,47392,25792,1356098
9/6/21,Canada,1404927,72.05,43241.62,46362,25844,1358565
10/6/21,Canada,1406417,73.3,43241.62,45393,25874,1361024
11/6/21,Canada,1407798,74.62,43241.62,44623,25887,1363175
12/6/21,Canada,1408935,75.72,43241.62,43989,25915,1364946
13/6/21,Canada,1409909,76.71,43241.62,43440,25932,1366469
14/6/21,Canada,1411228,77.89,43241.62,42287,25946,1368941
15/6/21,Canada,1412121,79.07,43241.62,41342,25973,1370779
16/6/21,Canada,1413203,80.29,43241.62,40661,26002,1372542
17/6/21,Canada,1414304,81.62,43241.62,40068,26013,1374236
18/6/21,Canada,1415272,83.02,43241.62,39563,26024,1375709
19/6/21,Canada,1416009,84.13,43241.62,39101,26055,1376908
20/6/21,Canada,1416589,85.05,43241.62,38708,26077,1377881
21/6/21,Canada,1417625,86.12,43241.62,37773,26103,1379852
22/6/21,Canada,1418135,87.36,43241.62,37012,26156,1381123
23/6/21,Canada,1418853,88.71,43241.62,36447,26176,1382406
24/6/21,Canada,1419569,90.27,43241.62,36190,26193,1383379
25/6/21,Canada,1420191,91.64,43241.62,35969,26198,1384222
26/6/21,Canada,1420724,92.81,43241.62,35799,26215,1384925
27/6/21,Canada,1421122,93.76,43241.62,35708,26228,1385414
28/6/21,Canada,1422053,95.61,43241.62,34525,26239,1387528
29/6/21,Canada,1422618,97.12,43241.62,34089,26275,1388529
30/6/21,Canada,1423170,98.72,43241.62,33683,26296,1389487
1/2/21,Chile,730888,0.35,13231.7,44514,18537,686374
2/2/21,Chile,734035,0.42,13231.7,43382,18559,690653
3/2/21,Chile,736645,1.31,13231.7,41685,18576,694960
4/2/21,Chile,740237,2.22,13231.7,41989,18731,698248
5/2/21,Chile,744019,3.11,13231.7,42704,18808,701315
6/2/21,Chile,748082,3.25,13231.7,42062,18895,706020
7/2/21,Chile,751886,3.3,13231.7,41857,18974,710029
8/2/21,Chile,755350,4.51,13231.7,41639,19056,713711
9/2/21,Chile,758189,5.87,13231.7,40881,19084,717308
10/2/21,Chile,760576,7.33,13231.7,39724,19105,720852
11/2/21,Chile,764307,8.66,13231.7,40814,19262,723493
12/2/21,Chile,768471,9.85,13231.7,42526,19345,725945
13/2/21,Chile,772396,10.01,13231.7,42192,19443,730204
14/2/21,Chile,776209,10.03,13231.7,42478,19541,733731
15/2/21,Chile,779541,11.41,13231.7,42415,19624,737126
16/2/21,Chile,782039,12.56,13231.7,41574,19644,740465
17/2/21,Chile,784314,13.54,13231.7,41008,19659,743306
18/2/21,Chile,788142,14.35,13231.7,41828,19798,746314
19/2/21,Chile,791939,15.09,13231.7,43019,19897,748920
20/2/21,Chile,795845,15.14,13231.7,42808,19974,753037
21/2/21,Chile,799460,15.14,13231.7,42696,20042,756764
22/2/21,Chile,803009,15.71,13231.7,42432,20126,760577
23/2/21,Chile,805317,16.2,13231.7,41413,20151,763904
24/2/21,Chile,807872,16.65,13231.7,40540,20173,767332
25/2/21,Chile,812344,17.09,13231.7,42154,20310,770190
26/2/21,Chile,816929,17.5,13231.7,43978,20400,772951
27/2/21,Chile,821418,17.55,13231.7,44463,20476,776955
28/2/21,Chile,824625,17.56,13231.7,44095,20572,780530
1/3/21,Chile,829770,18.27,13231.7,45557,20660,784213
2/3/21,Chile,832512,19.16,13231.7,44812,20684,787700
3/3/21,Chile,835552,20.79,13231.7,45024,20704,790528
4/3/21,Chile,840119,22.4,13231.7,46300,20838,793819
5/3/21,Chile,845450,23.96,13231.7,48659,20928,796791
6/3/21,Chile,850483,24.13,13231.7,48946,21008,801537
7/3/21,Chile,855785,24.17,13231.7,50083,21077,805702
8/3/21,Chile,860533,26,13231.7,50592,21163,809941
9/3/21,Chile,864064,27.96,13231.7,49976,21182,814088
10/3/21,Chile,867949,30.05,13231.7,49612,21206,818337
11/3/21,Chile,873512,32.22,13231.7,52142,21362,821370
12/3/21,Chile,879485,34.17,13231.7,54174,21451,825311
13/3/21,Chile,885379,34.43,13231.7,54681,21574,830698
14/3/21,Chile,891110,34.47,13231.7,55441,21674,835669
15/3/21,Chile,896231,36.71,13231.7,55563,21772,840668
16/3/21,Chile,900782,38.84,13231.7,55070,21789,845712
17/3/21,Chile,904212,40.76,13231.7,53058,21816,851154
18/3/21,Chile,911469,42.5,13231.7,56642,21988,854827
19/3/21,Chile,918053,44.03,13231.7,58956,22087,859097
20/3/21,Chile,925089,44.21,13231.7,59676,22180,865413
21/3/21,Chile,931939,44.23,13231.7,60705,22279,871234
22/3/21,Chile,938094,45.63,13231.7,60905,22359,877189
23/3/21,Chile,942958,46.89,13231.7,60186,22384,882772
24/3/21,Chile,947783,48.03,13231.7,58957,22402,888826
25/3/21,Chile,954843,49.13,13231.7,61870,22524,892973
26/3/21,Chile,962321,50.27,13231.7,64346,22587,897975
27/3/21,Chile,969913,50.35,13231.7,64478,22653,905435
28/3/21,Chile,977243,50.36,13231.7,65185,22754,912058
29/3/21,Chile,984484,51.75,13231.7,66038,23070,918446
30/3/21,Chile,989492,53.2,13231.7,64880,23107,924612
31/3/21,Chile,995538,54.66,13231.7,64268,23135,931270
1/4/21,Chile,1003406,56.23,13231.7,66685,23328,936721
2/4/21,Chile,1011485,56.27,13231.7,69072,23421,942413
3/4/21,Chile,1019478,56.29,13231.7,68589,23524,950889
4/4/21,Chile,1026785,56.29,13231.7,68385,23644,958400
5/4/21,Chile,1032612,57.78,13231.7,66971,23677,965641
6/4/21,Chile,1037780,59.03,13231.7,72139,23734,965641
7/4/21,Chile,1043022,60.24,13231.7,62777,23796,980245
8/4/21,Chile,1051270,61.49,13231.7,64985,23979,986285
9/4/21,Chile,1060421,62.63,13231.7,68745,24108,991676
10/4/21,Chile,1068522,62.76,13231.7,70122,24213,998400
11/4/21,Chile,1076499,62.78,13231.7,70639,24346,1005860
12/4/21,Chile,1082920,64.01,13231.7,70016,24483,1012904
13/4/21,Chile,1088710,65.24,13231.7,67785,24518,1020925
14/4/21,Chile,1094267,66.43,13231.7,67333,24548,1026934
15/4/21,Chile,1101698,67.51,13231.7,68509,24766,1033189
16/4/21,Chile,1109311,68.52,13231.7,71772,24923,1037539
17/4/21,Chile,1117348,68.64,13231.7,71541,25055,1045807
18/4/21,Chile,1124718,68.65,13231.7,71083,25177,1053635
19/4/21,Chile,1131340,69.67,13231.7,70544,25277,1060796
20/4/21,Chile,1136189,70.65,13231.7,68527,25317,1067662
21/4/21,Chile,1141403,71.58,13231.7,66576,25353,1074827
22/4/21,Chile,1148320,72.62,13231.7,67203,25532,1081117
23/4/21,Chile,1155902,73.58,13231.7,71071,25641,1084831
24/4/21,Chile,1162811,73.67,13231.7,69876,25742,1092935
25/4/21,Chile,1169536,73.68,13231.7,69618,25856,1099918
26/4/21,Chile,1175614,74.7,13231.7,68752,25975,1106862
27/4/21,Chile,1179772,75.59,13231.7,67309,26020,1112463
28/4/21,Chile,1184271,76.47,13231.7,64130,26073,1120141
29/4/21,Chile,1190991,77.28,13231.7,65230,26247,1125761
30/4/21,Chile,1198245,77.74,13231.7,68898,26353,1129347
1/5/21,Chile,1203755,77.75,13231.7,67558,26457,1136197
2/5/21,Chile,1210920,77.76,13231.7,67355,26561,1143565
3/5/21,Chile,1215815,78.55,13231.7,66020,26659,1149795
4/5/21,Chile,1219064,79.44,13231.7,63434,26696,1155630
5/5/21,Chile,1222949,80.35,13231.7,62004,26726,1160945
6/5/21,Chile,1229248,81.17,13231.7,63021,26895,1166227
7/5/21,Chile,1235778,81.94,13231.7,65341,27004,1170437
8/5/21,Chile,1241976,82.08,13231.7,64634,27101,1177342
9/5/21,Chile,1247469,82.08,13231.7,64314,27218,1183155
10/5/21,Chile,1252808,82.99,13231.7,63977,27318,1188831
11/5/21,Chile,1256546,83.99,13231.7,62619,27356,1193927
12/5/21,Chile,1260448,84.95,13231.7,61016,27384,1199432
13/5/21,Chile,1266601,85.77,13231.7,62425,27520,1204176
14/5/21,Chile,1273516,86.6,13231.7,65120,27647,1208396
15/5/21,Chile,1280252,86.6,13231.7,65435,27734,1214817
16/5/21,Chile,1286548,86.61,13231.7,66197,27832,1220351
17/5/21,Chile,1292096,87.5,13231.7,66250,27934,1225846
18/5/21,Chile,1295862,88.46,13231.7,64860,27965,1231002
19/5/21,Chile,1300629,89.33,13231.7,63219,27997,1237410
20/5/21,Chile,1308311,90.33,13231.7,66885,28169,1241426
21/5/21,Chile,1315913,90.38,13231.7,69925,28290,1245988
22/5/21,Chile,1323413,90.55,13231.7,70443,28386,1252970
23/5/21,Chile,1329918,90.57,13231.7,70838,28518,1259080
24/5/21,Chile,1335261,91.81,13231.7,70145,28548,1265116
25/5/21,Chile,1339421,93.09,13231.7,68911,28585,1270510
26/5/21,Chile,1344618,94.28,13231.7,67599,28624,1277019
27/5/21,Chile,1352723,95.34,13231.7,70162,28809,1282561
28/5/21,Chile,1361381,96.31,13231.7,73577,28928,1287804
29/5/21,Chile,1369597,96.56,13231.7,74098,29047,1295499
30/5/21,Chile,1377507,96.61,13231.7,74989,29168,1302518
31/5/21,Chile,1384346,97.73,13231.7,75306,29300,1309040
1/6/21,Chile,1389357,98.89,13231.7,73497,29344,1315860
2/6/21,Chile,1394973,99.95,13231.7,73373,29385,1321600
3/6/21,Chile,1403101,100.8,13231.7,75458,29598,1327643
4/6/21,Chile,1411346,101.56,13231.7,77715,29696,1333631
5/6/21,Chile,1420266,101.75,13231.7,78186,29816,1342080
6/6/21,Chile,1427956,101.78,13231.7,80280,29937,1347676
7/6/21,Chile,1434884,102.73,13231.7,79660,30058,1355224
8/6/21,Chile,1440417,103.69,13231.7,77986,30104,1362431
9/6/21,Chile,1445768,104.7,13231.7,75912,30141,1369856
10/6/21,Chile,1453477,105.75,13231.7,77142,30339,1376335
11/6/21,Chile,1461419,106.69,13231.7,79295,30472,1382124
12/6/21,Chile,1468992,106.85,13231.7,77976,30579,1391016
13/6/21,Chile,1476473,106.87,13231.7,77286,30707,1399187
14/6/21,Chile,1482663,108.02,13231.7,76108,30804,1406555
15/6/21,Chile,1487239,109.12,13231.7,73825,30865,1413414
16/6/21,Chile,1491561,110.3,13231.7,71196,30922,1420365
17/6/21,Chile,1498231,111.26,13231.7,71956,31140,1426275
18/6/21,Chile,1505001,111.82,13231.7,73486,31259,1431515
19/6/21,Chile,1511275,112.01,13231.7,72093,31392,1439182
20/6/21,Chile,1517018,112.03,13231.7,71315,31513,1445703
21/6/21,Chile,1522223,112.13,13231.7,70115,31645,1452108
22/6/21,Chile,1525933,113.74,13231.7,69261,31690,1456672
23/6/21,Chile,1528409,115.05,13231.7,65443,31746,1462966
24/6/21,Chile,1531872,116.37,13231.7,63735,31797,1468137
25/6/21,Chile,1537471,117.47,13231.7,65134,32012,1472337
26/6/21,Chile,1542642,117.74,13231.7,63801,32163,1478841
27/6/21,Chile,1547103,117.77,13231.7,62693,32298,1484410
28/6/21,Chile,1551137,117.8,13231.7,61600,32454,1489537
29/6/21,Chile,1553774,119.1,13231.7,59490,32489,1494284
30/6/21,Chile,1555902,120.17,13231.7,57110,32545,1498792
1/2/21,Ecuador,250986,0.05,5600.39,41172,14890,209814
2/2/21,Ecuador,251279,0.05,5600.39,41465,14915,209814
3/2/21,Ecuador,252390,0.07,5600.39,42576,14949,209814
4/2/21,Ecuador,253339,0.07,5600.39,43525,14968,209814
5/2/21,Ecuador,255412,0.07,5600.39,45598,14982,209814
6/2/21,Ecuador,257115,0.07,5600.39,47301,15004,209814
7/2/21,Ecuador,258282,0.07,5600.39,37884,15012,220398
8/2/21,Ecuador,258607,0.07,5600.39,38209,15013,220398
9/2/21,Ecuador,259783,0.07,5600.39,39385,15086,220398
10/2/21,Ecuador,260076,0.07,5600.39,39678,15116,220398
11/2/21,Ecuador,262213,0.08,5600.39,41815,15174,220398
12/2/21,Ecuador,263517,0.08,5600.39,43119,15220,220398
13/2/21,Ecuador,265527,0.08,5600.39,45129,15269,220398
14/2/21,Ecuador,267223,0.08,5600.39,36846,15321,230377
15/2/21,Ecuador,267701,0.08,5600.39,37324,15355,230377
16/2/21,Ecuador,268073,0.08,5600.39,37696,15392,230377
17/2/21,Ecuador,268219,0.08,5600.39,37842,15394,230377
18/2/21,Ecuador,269860,0.21,5600.39,39483,15444,230377
19/2/21,Ecuador,271276,0.24,5600.39,40899,15474,230377
20/2/21,Ecuador,273097,0.24,5600.39,42720,15513,230377
21/2/21,Ecuador,274673,0.25,5600.39,35856,15536,238817
22/2/21,Ecuador,274968,0.26,5600.39,36151,15547,238817
23/2/21,Ecuador,275780,0.26,5600.39,36963,15567,238817
24/2/21,Ecuador,278779,0.27,5600.39,39962,15634,238817
25/2/21,Ecuador,281169,0.37,5600.39,42352,15669,238817
26/2/21,Ecuador,282599,0.43,5600.39,43782,15713,238817
27/2/21,Ecuador,284347,0.43,5600.39,45530,15779,238817
28/2/21,Ecuador,286155,0.43,5600.39,38257,15811,247898
1/3/21,Ecuador,286367,0.43,5600.39,38469,15832,247898
2/3/21,Ecuador,286725,0.43,5600.39,38827,15850,247898
3/3/21,Ecuador,289472,0.43,5600.39,41574,15921,247898
4/3/21,Ecuador,289735,0.6,5600.39,41837,15959,247898
5/3/21,Ecuador,291070,0.71,5600.39,43172,15997,247898
6/3/21,Ecuador,292943,0.73,5600.39,45045,16020,247898
7/3/21,Ecuador,294503,0.73,5600.39,38494,16039,256009
8/3/21,Ecuador,294618,0.76,5600.39,38609,16043,256009
9/3/21,Ecuador,295114,0.76,5600.39,39105,16069,256009
10/3/21,Ecuador,296841,0.77,5600.39,40832,16105,256009
11/3/21,Ecuador,297957,0.97,5600.39,41948,16128,256009
12/3/21,Ecuador,299216,1.25,5600.39,43207,16193,256009
13/3/21,Ecuador,300666,1.34,5600.39,44657,16215,256009
14/3/21,Ecuador,302221,1.35,5600.39,39057,16236,263164
15/3/21,Ecuador,302498,1.41,5600.39,39334,16240,263164
16/3/21,Ecuador,302854,1.46,5600.39,39690,16259,263164
17/3/21,Ecuador,305598,1.49,5600.39,42434,16300,263164
18/3/21,Ecuador,307429,1.54,5600.39,44265,16333,263164
19/3/21,Ecuador,309643,1.59,5600.39,46479,16412,263164
20/3/21,Ecuador,310868,1.64,5600.39,47704,16435,263164
21/3/21,Ecuador,312598,1.65,5600.39,40751,16451,271847
22/3/21,Ecuador,312851,1.89,5600.39,41004,16478,271847
23/3/21,Ecuador,313570,2.02,5600.39,41723,16504,271847
24/3/21,Ecuador,316807,2.07,5600.39,44960,16540,271847
25/3/21,Ecuador,318656,2.19,5600.39,46809,16582,271847
26/3/21,Ecuador,321451,2.33,5600.39,49604,16632,271847
27/3/21,Ecuador,322699,2.37,5600.39,50852,16679,271847
28/3/21,Ecuador,324482,2.37,5600.39,42798,16738,281684
29/3/21,Ecuador,325124,2.48,5600.39,43440,16746,281684
30/3/21,Ecuador,327325,2.55,5600.39,45641,16780,281684
31/3/21,Ecuador,328755,2.62,5600.39,47071,16847,281684
1/4/21,Ecuador,330388,2.81,5600.39,48704,16877,281684
2/4/21,Ecuador,332038,2.88,5600.39,50354,16910,281684
3/4/21,Ecuador,333175,2.92,5600.39,51491,16929,281684
4/4/21,Ecuador,335681,2.94,5600.39,45367,16956,290314
5/4/21,Ecuador,336777,3.22,5600.39,46463,16987,290314
6/4/21,Ecuador,337702,3.44,5600.39,47388,17004,290314
7/4/21,Ecuador,339604,3.69,5600.39,49290,17057,290314
8/4/21,Ecuador,341619,3.78,5600.39,51305,17115,290314
9/4/21,Ecuador,342678,3.84,5600.39,52364,17158,290314
10/4/21,Ecuador,344877,3.85,5600.39,54563,17275,290314
11/4/21,Ecuador,346817,3.85,5600.39,56503,17293,290314
12/4/21,Ecuador,347070,3.9,5600.39,56756,17298,290314
13/4/21,Ecuador,347589,4.18,5600.39,48985,17351,298604
14/4/21,Ecuador,350539,4.36,5600.39,51935,17400,298604
15/4/21,Ecuador,355431,4.57,5600.39,56827,17489,298604
16/4/21,Ecuador,355964,4.82,5600.39,57360,17528,298604
17/4/21,Ecuador,358157,5.07,5600.39,59553,17641,298604
18/4/21,Ecuador,360546,5.09,5600.39,51005,17703,309541
19/4/21,Ecuador,360563,5.32,5600.39,51022,17703,309541
20/4/21,Ecuador,361154,5.59,5600.39,51613,17744,309541
21/4/21,Ecuador,362843,5.93,5600.39,53302,17804,309541
22/4/21,Ecuador,365393,6.2,5600.39,55852,17965,309541
23/4/21,Ecuador,371306,6.53,5600.39,61765,18062,309541
24/4/21,Ecuador,372754,6.66,5600.39,63213,18158,309541
25/4/21,Ecuador,373362,6.7,5600.39,54764,18177,318598
26/4/21,Ecuador,374775,6.97,5600.39,56177,18300,318598
27/4/21,Ecuador,375329,7.31,5600.39,56731,18389,318598
28/4/21,Ecuador,377662,7.62,5600.39,59064,18470,318598
29/4/21,Ecuador,380689,8.02,5600.39,62091,18552,318598
30/4/21,Ecuador,381862,8.4,5600.39,63264,18631,318598
1/5/21,Ecuador,384589,8.7,5600.39,65991,18724,318598
2/5/21,Ecuador,387299,8.93,5600.39,57717,18740,329582
3/5/21,Ecuador,388046,9.21,5600.39,58464,18765,329582
4/5/21,Ecuador,391242,9.43,5600.39,61660,18863,329582
5/5/21,Ecuador,393048,9.72,5600.39,63466,18907,329582
6/5/21,Ecuador,395327,10.04,5600.39,65745,19018,329582
7/5/21,Ecuador,396888,10.3,5600.39,67306,19061,329582
8/5/21,Ecuador,398921,10.4,5600.39,69339,19137,329582
9/5/21,Ecuador,400296,10.43,5600.39,57418,19222,342878
10/5/21,Ecuador,402060,10.6,5600.39,59182,19242,342878
11/5/21,Ecuador,402595,10.81,5600.39,59717,19286,342878
12/5/21,Ecuador,404632,11.04,5600.39,61754,19349,342878
13/5/21,Ecuador,405783,11.29,5600.39,62905,19442,342878
14/5/21,Ecuador,407002,11.64,5600.39,64124,19514,342878
15/5/21,Ecuador,409520,11.86,5600.39,66642,19692,342878
16/5/21,Ecuador,410129,11.98,5600.39,55630,19699,354499
17/5/21,Ecuador,410870,12.25,5600.39,56371,19786,354499
18/5/21,Ecuador,411466,12.5,5600.39,56967,19877,354499
19/5/21,Ecuador,412907,12.77,5600.39,58408,19979,354499
20/5/21,Ecuador,415255,13.21,5600.39,60756,20022,354499
21/5/21,Ecuador,416621,13.68,5600.39,62122,20107,354499
22/5/21,Ecuador,417840,14,5600.39,63341,20180,354499
23/5/21,Ecuador,418851,14.51,5600.39,64352,20193,354499
24/5/21,Ecuador,419198,14.53,5600.39,52773,20210,366425
25/5/21,Ecuador,420167,14.56,5600.39,53742,20227,366425
26/5/21,Ecuador,421231,14.89,5600.39,54806,20312,366425
27/5/21,Ecuador,422329,15.23,5600.39,55904,20357,366425
28/5/21,Ecuador,423165,15.54,5600.39,56740,20408,366425
29/5/21,Ecuador,424741,15.75,5600.39,58316,20485,366425
30/5/21,Ecuador,425841,15.86,5600.39,50690,20545,375151
31/5/21,Ecuador,426037,16.19,5600.39,50886,20572,375151
1/6/21,Ecuador,427690,16.47,5600.39,52539,20620,375151
2/6/21,Ecuador,428865,16.8,5600.39,53714,20681,375151
3/6/21,Ecuador,429817,17.24,5600.39,54666,20706,375151
4/6/21,Ecuador,430739,17.76,5600.39,55588,20755,375151
5/6/21,Ecuador,431429,18.02,5600.39,56278,20773,375151
6/6/21,Ecuador,432353,18.2,5600.39,33708,20809,398645
7/6/21,Ecuador,432739,18.53,5600.39,34094,20814,398645
8/6/21,Ecuador,432985,18.87,5600.39,34340,20831,398645
9/6/21,Ecuador,433870,19.21,5600.39,35225,20903,398645
10/6/21,Ecuador,436023,19.61,5600.39,37378,20949,398645
11/6/21,Ecuador,437121,20.08,5600.39,38476,20997,398645
12/6/21,Ecuador,438108,20.36,5600.39,39463,21018,398645
13/6/21,Ecuador,438934,20.56,5600.39,40289,21048,398645
14/6/21,Ecuador,439139,20.88,5600.39,40494,21051,398645
15/6/21,Ecuador,439374,21.26,5600.39,40729,21061,398645
16/6/21,Ecuador,441180,21.79,5600.39,33668,21153,407512
17/6/21,Ecuador,442341,22.37,5600.39,34829,21175,407512
18/6/21,Ecuador,444395,22.89,5600.39,36883,21234,407512
19/6/21,Ecuador,445586,23.19,5600.39,38074,21284,407512
20/6/21,Ecuador,446441,23.28,5600.39,30933,21293,415508
21/6/21,Ecuador,446633,23.66,5600.39,31125,21304,415508
22/6/21,Ecuador,447176,24.05,5600.39,31668,21315,415508
23/6/21,Ecuador,449107,24.46,5600.39,33599,21367,415508
24/6/21,Ecuador,449483,24.93,5600.39,33975,21377,415508
25/6/21,Ecuador,452234,25.32,5600.39,36726,21433,415508
26/6/21,Ecuador,453365,25.63,5600.39,37857,21485,415508
27/6/21,Ecuador,454336,25.75,5600.39,30648,21523,423688
28/6/21,Ecuador,455743,26.14,5600.39,32055,21523,423688
29/6/21,Ecuador,457489,26.5,5600.39,33801,21545,423688
30/6/21,Ecuador,458504,26.95,5600.39,34816,21560,423688
1/2/21,Portugal,726321,3.74,22439.88,191937,12757,534384
2/2/21,Portugal,731861,3.77,22439.88,179905,13017,551956
3/2/21,Portugal,740944,3.86,22439.88,177770,13257,563174
4/2/21,Portugal,748858,3.99,22439.88,174924,13482,573934
5/2/21,Portugal,755774,4.14,22439.88,170498,13740,585276
6/2/21,Portugal,761906,4.29,22439.88,162313,13954,599593
7/2/21,Portugal,765414,4.3,22439.88,159248,14158,606166
8/2/21,Portugal,767919,4.35,22439.88,154998,14354,612921
9/2/21,Portugal,770502,4.39,22439.88,142424,14557,628078
10/2/21,Portugal,774889,4.53,22439.88,138030,14718,636859
11/2/21,Portugal,778369,4.74,22439.88,133247,14885,645122
12/2/21,Portugal,781223,5.06,22439.88,128484,15034,652739
13/2/21,Portugal,784079,5.42,22439.88,122554,15183,661525
14/2/21,Portugal,785756,5.6,22439.88,120440,15321,665316
15/2/21,Portugal,787059,5.73,22439.88,118205,15411,668854
16/2/21,Portugal,788561,5.84,22439.88,110842,15522,677719
17/2/21,Portugal,790885,6,22439.88,107824,15649,683061
18/2/21,Portugal,792829,6.22,22439.88,105367,15754,687462
19/2/21,Portugal,794769,6.61,22439.88,102903,15821,691866
20/2/21,Portugal,796339,6.99,22439.88,99423,15897,696916
21/2/21,Portugal,797525,7.17,22439.88,98303,15962,699222
22/2/21,Portugal,798074,7.25,22439.88,96665,16023,701409
23/2/21,Portugal,799106,7.39,22439.88,93130,16086,705976
24/2/21,Portugal,800586,7.65,22439.88,91532,16136,709054
25/2/21,Portugal,801746,7.96,22439.88,90033,16185,711713
26/2/21,Portugal,802773,8.4,22439.88,88280,16243,714493
27/2/21,Portugal,803844,8.8,22439.88,86531,16276,717313
28/2/21,Portugal,804562,9.04,22439.88,85585,16317,718977
1/3/21,Portugal,804956,9.2,22439.88,84721,16351,720235
2/3/21,Portugal,805647,9.36,22439.88,82182,16389,723465
3/3/21,Portugal,806626,9.51,22439.88,81227,16430,725399
4/3/21,Portugal,807456,9.79,22439.88,80403,16458,727053
5/3/21,Portugal,808405,10.22,22439.88,79746,16486,728659
6/3/21,Portugal,809412,10.61,22439.88,78811,16512,730601
7/3/21,Portugal,810094,10.78,22439.88,78527,16540,731567
8/3/21,Portugal,810459,10.91,22439.88,78113,16565,732346
9/3/21,Portugal,811306,11.01,22439.88,77088,16595,734218
10/3/21,Portugal,811948,11.12,22439.88,73769,16617,738179
11/3/21,Portugal,812575,11.36,22439.88,68379,16635,744196
12/3/21,Portugal,813152,11.7,22439.88,63382,16650,749770
13/3/21,Portugal,813716,12.03,22439.88,57457,16669,756259
14/3/21,Portugal,814257,12.19,22439.88,54840,16684,759417
15/3/21,Portugal,814513,12.37,22439.88,52725,16694,761788
16/3/21,Portugal,814897,12.62,22439.88,51936,16707,762961
17/3/21,Portugal,815570,12.69,22439.88,51551,16722,764019
18/3/21,Portugal,816055,13.03,22439.88,51456,16743,764599
19/3/21,Portugal,816623,13.48,22439.88,50453,16754,766170
20/3/21,Portugal,817080,13.92,22439.88,50156,16762,766924
21/3/21,Portugal,817530,14.14,22439.88,50211,16768,767319
22/3/21,Portugal,817778,14.27,22439.88,49904,16784,767874
23/3/21,Portugal,818212,14.45,22439.88,49126,16794,769086
24/3/21,Portugal,818787,14.67,22439.88,48949,16805,769838
25/3/21,Portugal,819210,15.09,22439.88,48762,16814,770448
26/3/21,Portugal,819698,15.79,22439.88,48359,16819,771339
27/3/21,Portugal,820042,16.09,22439.88,45035,16827,775007
28/3/21,Portugal,820407,16.71,22439.88,45016,16837,775391
29/3/21,Portugal,820716,17.03,22439.88,44867,16843,775849
30/3/21,Portugal,821104,17.26,22439.88,43601,16845,777503
31/3/21,Portugal,821722,17.57,22439.88,43512,16848,778210
1/4/21,Portugal,822314,17.8,22439.88,43402,16859,778912
2/4/21,Portugal,822862,18.62,22439.88,43207,16868,779655
3/4/21,Portugal,823142,18.97,22439.88,43169,16875,779973
4/4/21,Portugal,823335,19.15,22439.88,43013,16879,780322
5/4/21,Portugal,823494,19.24,22439.88,42851,16885,780643
6/4/21,Portugal,824368,19.56,22439.88,42831,16887,781537
7/4/21,Portugal,825031,19.95,22439.88,42737,16890,782294
8/4/21,Portugal,825633,20.56,22439.88,42738,16899,782895
9/4/21,Portugal,826327,21.25,22439.88,42804,16904,783523
10/4/21,Portugal,826928,21.93,22439.88,42720,16910,784208
11/4/21,Portugal,827494,22.06,22439.88,42876,16916,784618
12/4/21,Portugal,827765,22.3,22439.88,42702,16918,785063
13/4/21,Portugal,828173,22.61,22439.88,42364,16923,785809
14/4/21,Portugal,828857,23.05,22439.88,42388,16931,786469
15/4/21,Portugal,829358,23.67,22439.88,42347,16933,787011
16/4/21,Portugal,829911,24.36,22439.88,42304,16937,787607
17/4/21,Portugal,830560,25.02,22439.88,42286,16942,788274
18/4/21,Portugal,831001,26.19,22439.88,42332,16945,788669
19/4/21,Portugal,831221,27.03,22439.88,42005,16946,789216
20/4/21,Portugal,831645,27.35,22439.88,41527,16951,790118
21/4/21,Portugal,832255,27.73,22439.88,41605,16952,790650
22/4/21,Portugal,832891,28.26,22439.88,41720,16956,791171
23/4/21,Portugal,833397,28.92,22439.88,41646,16957,791751
24/4/21,Portugal,833964,29.69,22439.88,41587,16959,792377
25/4/21,Portugal,834442,30.11,22439.88,41757,16965,792685
26/4/21,Portugal,834638,30.49,22439.88,41627,16965,793011
27/4/21,Portugal,834991,30.97,22439.88,40786,16970,794205
28/4/21,Portugal,835563,31.46,22439.88,40782,16973,794781
29/4/21,Portugal,836033,32.17,22439.88,40707,16974,795326
30/4/21,Portugal,836493,32.97,22439.88,40655,16974,795838
1/5/21,Portugal,836947,33.81,22439.88,40470,16976,796477
2/5/21,Portugal,837277,34.32,22439.88,40556,16977,796721
3/5/21,Portugal,837457,34.79,22439.88,40333,16977,797124
4/5/21,Portugal,837715,35.43,22439.88,39814,16981,797901
5/5/21,Portugal,838102,36.19,22439.88,39688,16983,798414
6/5/21,Portugal,838475,37.08,22439.88,39523,16988,798952
7/5/21,Portugal,838852,38.08,22439.88,39410,16989,799442
8/5/21,Portugal,839258,39.1,22439.88,39251,16991,800007
9/5/21,Portugal,839582,39.91,22439.88,39305,16992,800277
10/5/21,Portugal,839740,40.62,22439.88,39095,16993,800645
11/5/21,Portugal,840008,41.39,22439.88,38702,16994,801306
12/5/21,Portugal,840493,42.07,22439.88,38872,16998,801621
13/5/21,Portugal,840929,42.75,22439.88,38968,16999,801961
14/5/21,Portugal,841379,43.46,22439.88,39094,16999,802285
15/5/21,Portugal,841848,44.24,22439.88,39177,17006,802671
16/5/21,Portugal,842182,45.52,22439.88,39282,17007,802900
17/5/21,Portugal,842381,46.49,22439.88,39190,17009,803191
18/5/21,Portugal,842767,47.16,22439.88,39008,17011,803759
19/5/21,Portugal,843278,47.94,22439.88,39102,17013,804176
20/5/21,Portugal,843729,48.72,22439.88,39207,17014,804522
21/5/21,Portugal,844288,49.54,22439.88,39304,17017,804984
22/5/21,Portugal,844811,50.38,22439.88,39345,17017,805466
23/5/21,Portugal,845224,51.08,22439.88,39532,17017,805692
24/5/21,Portugal,845465,51.68,22439.88,39486,17018,805979
25/5/21,Portugal,845840,52.35,22439.88,39192,17021,806648
26/5/21,Portugal,846434,53.02,22439.88,39369,17022,807065
27/5/21,Portugal,847006,53.89,22439.88,39474,17022,807532
28/5/21,Portugal,847604,54.86,22439.88,39557,17023,808047
29/5/21,Portugal,848213,55.88,22439.88,39656,17023,808557
30/5/21,Portugal,848658,56.6,22439.88,39845,17023,808813
31/5/21,Portugal,849093,57.22,22439.88,39958,17025,809135
1/6/21,Portugal,849538,57.91,22439.88,39725,17025,809813
2/6/21,Portugal,850262,58.78,22439.88,39991,17026,810271
3/6/21,Portugal,851031,59.66,22439.88,40372,17029,810659
4/6/21,Portugal,851461,60.36,22439.88,40502,17029,810959
5/6/21,Portugal,852034,61.25,22439.88,40394,17032,811640
6/6/21,Portugal,852646,62.05,22439.88,40749,17034,811897
7/6/21,Portugal,853034,62.84,22439.88,40860,17036,812174
8/6/21,Portugal,853632,63.86,22439.88,40668,17037,812964
9/6/21,Portugal,854522,64.8,22439.88,41033,17037,813489
10/6/21,Portugal,855432,65.78,22439.88,41409,17043,814023
11/6/21,Portugal,855951,66.88,22439.88,41633,17044,814318
12/6/21,Portugal,856740,67.44,22439.88,41646,17045,815094
13/6/21,Portugal,857447,68.14,22439.88,42105,17047,815342
14/6/21,Portugal,858072,68.87,22439.88,42450,17047,815622
15/6/21,Portugal,859045,69.78,22439.88,42542,17049,816503
16/6/21,Portugal,860395,70.79,22439.88,43303,17055,817092
17/6/21,Portugal,861628,71.88,22439.88,43874,17057,817754
18/6/21,Portugal,862926,73.54,22439.88,44486,17061,818440
19/6/21,Portugal,864109,74.04,22439.88,44785,17062,819324
20/6/21,Portugal,865050,75.4,22439.88,45362,17065,819688
21/6/21,Portugal,865806,76.09,22439.88,45725,17068,820081
22/6/21,Portugal,866826,76.4,22439.88,45452,17074,821374
23/6/21,Portugal,868323,77.45,22439.88,46089,17077,822234
24/6/21,Portugal,869879,78.53,22439.88,46776,17079,823103
25/6/21,Portugal,871483,79.63,22439.88,47523,17081,823960
26/6/21,Portugal,873051,80.71,22439.88,47842,17083,825209
27/6/21,Portugal,874547,81.67,22439.88,48863,17084,825684
28/6/21,Portugal,875449,83.21,22439.88,49157,17086,826292
29/6/21,Portugal,877195,84.34,22439.88,49226,17092,827969
30/6/21,Portugal,879557,85.52,22439.88,50567,17096,828990
1/2/21,Germany,2232327,3.18,45723.64,265195,58059,1967132
2/2/21,Germany,2240017,3.33,45723.64,253803,58992,1986214
3/2/21,Germany,2252504,3.53,45723.64,248673,59776,2003831
4/2/21,Germany,2265536,3.69,45723.64,245233,60634,2020303
5/2/21,Germany,2276371,3.86,45723.64,243203,61324,2033168
6/2/21,Germany,2285003,3.98,45723.64,243015,61551,2041988
7/2/21,Germany,2291673,4.04,45723.64,239017,61708,2052656
8/2/21,Germany,2296323,4.17,45723.64,241983,62191,2054340
9/2/21,Germany,2302051,4.33,45723.64,220085,63006,2081966
10/2/21,Germany,2311297,4.52,45723.64,214522,63672,2096775
11/2/21,Germany,2321225,4.69,45723.64,211717,64224,2109508
12/2/21,Germany,2330422,4.87,45723.64,210080,64771,2120342
13/2/21,Germany,2336906,5,45723.64,208904,64990,2128002
14/2/21,Germany,2341744,5.08,45723.64,204811,65107,2136933
15/2/21,Germany,2346876,5.23,45723.64,198607,65288,2148269
16/2/21,Germany,2352766,5.39,45723.64,191666,65829,2161100
17/2/21,Germany,2362364,5.57,45723.64,190052,66732,2172312
18/2/21,Germany,2372209,5.75,45723.64,189839,67245,2182370
19/2/21,Germany,2381259,5.94,45723.64,190051,67741,2191208
20/2/21,Germany,2388421,6.07,45723.64,191356,67883,2197065
21/2/21,Germany,2394515,6.17,45723.64,190405,67946,2204110
22/2/21,Germany,2399499,6.36,45723.64,187060,68363,2212439
23/2/21,Germany,2405263,6.56,45723.64,183291,68785,2221972
24/2/21,Germany,2416037,6.77,45723.64,184964,69170,2231073
25/2/21,Germany,2427069,7,45723.64,195019,69343,2232050
26/2/21,Germany,2436506,7.25,45723.64,189333,69939,2247173
27/2/21,Germany,2444177,7.43,45723.64,191207,70092,2252970
28/2/21,Germany,2450295,7.55,45723.64,190747,70152,2259548
1/3/21,Germany,2455569,7.79,45723.64,194850,70514,2260719
2/3/21,Germany,2462061,8.05,45723.64,184435,70926,2277626
3/3/21,Germany,2472913,8.35,45723.64,186185,71285,2286728
4/3/21,Germany,2484306,8.64,45723.64,188901,71554,2295405
5/3/21,Germany,2493887,8.97,45723.64,190988,71852,2302899
6/3/21,Germany,2502151,9.21,45723.64,194057,71951,2308094
7/3/21,Germany,2508655,9.39,45723.64,194255,71984,2314400
8/3/21,Germany,2513784,9.67,45723.64,191050,72236,2322734
9/3/21,Germany,2520618,9.98,45723.64,188728,72534,2331890
10/3/21,Germany,2541781,10.32,45723.64,201308,72858,2340473
11/3/21,Germany,2546526,10.66,45723.64,197142,73120,2349384
12/3/21,Germany,2559296,11.05,45723.64,202706,73348,2356590
13/3/21,Germany,2569864,11.34,45723.64,212490,73369,2357374
14/3/21,Germany,2578842,11.54,45723.64,209847,73463,2368995
15/3/21,Germany,2585385,11.84,45723.64,207801,73701,2377584
16/3/21,Germany,2595058,12.05,45723.64,207826,73953,2387232
17/3/21,Germany,2612908,12.3,45723.64,225165,74177,2387743
18/3/21,Germany,2629960,12.53,45723.64,224360,74402,2405600
19/3/21,Germany,2646107,12.82,45723.64,232523,74609,2413584
20/3/21,Germany,2659792,13.09,45723.64,240500,74707,2419292
21/3/21,Germany,2670001,13.28,45723.64,243301,74756,2426700
22/3/21,Germany,2678262,13.6,45723.64,241079,75009,2437183
23/3/21,Germany,2699231,13.96,45723.64,250403,75255,2448828
24/3/21,Germany,2722988,14.37,45723.64,262969,75484,2460019
25/3/21,Germany,2744608,14.77,45723.64,273050,75669,2471558
26/3/21,Germany,2765297,15.22,45723.64,283389,75828,2481908
27/3/21,Germany,2782925,15.55,45723.64,293727,75915,2489198
28/3/21,Germany,2784652,15.79,45723.64,285642,75959,2499010
29/3/21,Germany,2794949,16.15,45723.64,283532,76139,2511417
30/3/21,Germany,2818630,16.54,45723.64,293050,76389,2525580
31/3/21,Germany,2843644,16.95,45723.64,303984,76589,2539660
1/4/21,Germany,2866323,17.34,45723.64,314303,76823,2552020
2/4/21,Germany,2882356,17.61,45723.64,315826,76940,2566530
3/4/21,Germany,2886029,17.89,45723.64,310289,77010,2575740
4/4/21,Germany,2896329,18.12,45723.64,310479,77060,2585850
5/4/21,Germany,2902309,18.41,45723.64,314729,77136,2587580
6/4/21,Germany,2909902,18.86,45723.64,305012,77245,2604890
7/4/21,Germany,2940279,19.66,45723.64,301959,77755,2638320
8/4/21,Germany,2966789,20.49,45723.64,326489,78049,2640300
9/4/21,Germany,2990724,21.25,45723.64,335794,78295,2654930
10/4/21,Germany,3009452,21.69,45723.64,340542,78402,2668910
11/4/21,Germany,3012158,22.01,45723.64,319928,78500,2692230
12/4/21,Germany,3024604,22.51,45723.64,316284,78796,2708320
13/4/21,Germany,3054025,23.19,45723.64,327115,79137,2726910
14/4/21,Germany,3085142,24.12,45723.64,340202,79427,2744940
15/4/21,Germany,3110252,24.93,45723.64,362792,79672,2747460
16/4/21,Germany,3134108,25.65,45723.64,370848,79894,2763260
17/4/21,Germany,3154305,26.08,45723.64,369765,79971,2784540
18/4/21,Germany,3155522,26.4,45723.64,360442,80052,2795080
19/4/21,Germany,3167137,26.89,45723.64,355247,80353,2811890
20/4/21,Germany,3198534,27.56,45723.64,367094,80680,2831440
21/4/21,Germany,3222888,28.42,45723.64,369998,80938,2852890
22/4/21,Germany,3254609,29.18,45723.64,398099,81203,2856510
23/4/21,Germany,3276871,29.84,45723.64,400181,81492,2876690
24/4/21,Germany,3291293,30.28,45723.64,388393,81610,2902900
25/4/21,Germany,3306692,30.62,45723.64,388962,81671,2917730
26/4/21,Germany,3312653,31.14,45723.64,372753,82009,2939900
27/4/21,Germany,3338564,32.07,45723.64,377664,82325,2960900
28/4/21,Germany,3366827,33.41,45723.64,400237,82588,2966590
29/4/21,Germany,3391039,34.54,45723.64,403129,82865,2987910
30/4/21,Germany,3405365,35.5,45723.64,396725,83097,3008640
1/5/21,Germany,3423900,35.91,45723.64,398780,83207,3025120
2/5/21,Germany,3432676,36.22,45723.64,380946,83292,3051730
3/5/21,Germany,3438186,36.76,45723.64,384416,83605,3053770
4/5/21,Germany,3462297,37.77,45723.64,387067,83890,3075230
5/5/21,Germany,3484755,39.14,45723.64,366095,84141,3118660
6/5/21,Germany,3502672,40.32,45723.64,362342,84425,3140330
7/5/21,Germany,3517762,41.39,45723.64,375122,84659,3142640
8/5/21,Germany,3530887,41.89,45723.64,370257,84789,3160630
9/5/21,Germany,3530887,42.24,45723.64,343787,84844,3187100
10/5/21,Germany,3538208,42.94,45723.64,349498,85118,3188710
11/5/21,Germany,3557904,44.24,45723.64,326814,85385,3231090
12/5/21,Germany,3564494,45.93,45723.64,330864,85451,3233630
13/5/21,Germany,3578125,46.44,45723.64,309935,85853,3268190
14/5/21,Germany,3588502,47.34,45723.64,304202,86030,3284300
15/5/21,Germany,3595872,47.82,45723.64,303172,86100,3292700
16/5/21,Germany,3602939,48.16,45723.64,296679,86166,3306260
17/5/21,Germany,3608320,48.82,45723.64,285130,86386,3323190
18/5/21,Germany,3615896,49.86,45723.64,273546,86671,3342350
19/5/21,Germany,3627777,51.17,45723.64,268247,86908,3359530
20/5/21,Germany,3638504,52.3,45723.64,262404,87135,3376100
21/5/21,Germany,3646600,53.32,45723.64,256200,87303,3390400
22/5/21,Germany,3653019,53.88,45723.64,254319,87385,3398700
23/5/21,Germany,3657662,54.22,45723.64,247622,87429,3410040
24/5/21,Germany,3659990,54.61,45723.64,234610,87461,3425380
25/5/21,Germany,3662568,55.4,45723.64,222998,87733,3439570
26/5/21,Germany,3667041,56.8,45723.64,214751,88000,3452290
27/5/21,Germany,3673990,58.04,45723.64,210860,88192,3463130
28/5/21,Germany,3680159,59.12,45723.64,207509,88360,3472650
29/5/21,Germany,3684672,59.61,45723.64,204972,88413,3479700
30/5/21,Germany,3687715,59.95,45723.64,199865,88431,3487850
31/5/21,Germany,3689921,60.61,45723.64,191341,88601,3498580
1/6/21,Germany,3692908,61.78,45723.64,183248,88781,3509660
2/6/21,Germany,3698004,63.27,45723.64,179144,88945,3518860
3/6/21,Germany,3701692,64.04,45723.64,175582,89031,3526110
4/6/21,Germany,3704685,65.01,45723.64,170825,89152,3533860
5/6/21,Germany,3706934,65.5,45723.64,168644,89228,3538290
6/6/21,Germany,3708898,65.85,45723.64,166898,89249,3542000
7/6/21,Germany,3710342,66.58,45723.64,160522,89390,3549820
8/6/21,Germany,3712595,67.85,45723.64,154755,89497,3557840
9/6/21,Germany,3715870,69.55,45723.64,152730,89592,3563140
10/6/21,Germany,3718617,70.97,45723.64,150157,89693,3568460
11/6/21,Germany,3720811,72.24,45723.64,146811,89821,3574000
12/6/21,Germany,3722295,72.77,45723.64,144455,89841,3577840
13/6/21,Germany,3723295,73.1,45723.64,141955,89849,3581340
14/6/21,Germany,3724168,73.89,45723.64,138508,89944,3585660
15/6/21,Germany,3725328,75.14,45723.64,134718,90079,3590610
16/6/21,Germany,3726767,76.79,45723.64,133037,90185,3593730
17/6/21,Germany,3727668,78.16,45723.64,129728,90277,3597940
18/6/21,Germany,3728601,79.35,45723.64,128241,90374,3600360
19/6/21,Germany,3729597,79.86,45723.64,127447,90390,3602150
20/6/21,Germany,3730126,80.21,45723.64,126076,90400,3604050
21/6/21,Germany,3730619,80.97,45723.64,124469,90477,3606150
22/6/21,Germany,3731304,82.26,45723.64,121994,90553,3609310
23/6/21,Germany,3732439,83.85,45723.64,119599,90620,3612840
24/6/21,Germany,3732914,85.09,45723.64,116774,90685,3616140
25/6/21,Germany,3733665,86.19,45723.64,116195,90752,3617470
26/6/21,Germany,3734153,86.68,45723.64,115643,90761,3618510
27/6/21,Germany,3734489,87.03,45723.64,115479,90768,3619010
28/6/21,Germany,3734830,87.78,45723.64,114000,90826,3620830
29/6/21,Germany,3735399,88.9,45723.64,113179,90883,3622220
30/6/21,Germany,3736205,90.12,45723.64,112405,90945,3623800
1/2/21,Ireland,197553,4.31,83812.8,174189,3317,23364
2/2/21,Ireland,198424,4.43,83812.8,175060,3418,23364
3/2/21,Ireland,199430,4.59,83812.8,176066,3512,23364
4/2/21,Ireland,200744,4.83,83812.8,177380,3586,23364
5/2/21,Ireland,201763,5.07,83812.8,178399,3621,23364
6/2/21,Ireland,202548,5.16,83812.8,179184,3674,23364
7/2/21,Ireland,203568,5.19,83812.8,180204,3686,23364
8/2/21,Ireland,204397,5.23,83812.8,181033,3687,23364
9/2/21,Ireland,204940,5.33,83812.8,181576,3752,23364
10/2/21,Ireland,205939,5.52,83812.8,182575,3794,23364
11/2/21,Ireland,206801,5.65,83812.8,183437,3846,23364
12/2/21,Ireland,207720,5.74,83812.8,184356,3865,23364
13/2/21,Ireland,208796,5.81,83812.8,185432,3931,23364
14/2/21,Ireland,209582,5.86,83812.8,186218,3948,23364
15/2/21,Ireland,210402,6.05,83812.8,187038,3948,23364
16/2/21,Ireland,211113,6.33,83812.8,187749,3980,23364
17/2/21,Ireland,211751,6.69,83812.8,188387,4036,23364
18/2/21,Ireland,212647,7.03,83812.8,189283,4082,23364
19/2/21,Ireland,213400,7.35,83812.8,190036,4109,23364
20/2/21,Ireland,214378,7.54,83812.8,191014,4135,23364
21/2/21,Ireland,215057,7.58,83812.8,191693,4136,23364
22/2/21,Ireland,215743,7.68,83812.8,192379,4137,23364
23/2/21,Ireland,216300,7.97,83812.8,192936,4181,23364
24/2/21,Ireland,216840,8.35,83812.8,193476,4237,23364
25/2/21,Ireland,217478,8.74,83812.8,194114,4271,23364
26/2/21,Ireland,218251,9.12,83812.8,194887,4300,23364
27/2/21,Ireland,218980,9.31,83812.8,195616,4313,23364
28/2/21,Ireland,219592,9.36,83812.8,196228,4319,23364
1/3/21,Ireland,220273,9.49,83812.8,196909,4319,23364
2/3/21,Ireland,220630,9.76,83812.8,197266,4333,23364
3/3/21,Ireland,221189,10.04,83812.8,197825,4357,23364
4/3/21,Ireland,221649,10.45,83812.8,198285,4396,23364
5/3/21,Ireland,222169,10.87,83812.8,198805,4405,23364
6/3/21,Ireland,222699,11.08,83812.8,199335,4419,23364
7/3/21,Ireland,223219,11.11,83812.8,199855,4422,23364
8/3/21,Ireland,223651,11.27,83812.8,200287,4422,23364
9/3/21,Ireland,223957,11.6,83812.8,200593,4452,23364
10/3/21,Ireland,224588,11.95,83812.8,201224,4499,23364
11/3/21,Ireland,225179,12.36,83812.8,201815,4509,23364
12/3/21,Ireland,225820,12.73,83812.8,202456,4518,23364
13/3/21,Ireland,226358,12.9,83812.8,202994,4534,23364
14/3/21,Ireland,226741,12.91,83812.8,203377,4534,23364
15/3/21,Ireland,227316,12.98,83812.8,203952,4534,23364
16/3/21,Ireland,227663,13.23,83812.8,204299,4552,23364
17/3/21,Ireland,228215,13.37,83812.8,204851,4566,23364
18/3/21,Ireland,228796,13.7,83812.8,205432,4566,23364
19/3/21,Ireland,229306,14.03,83812.8,205942,4576,23364
20/3/21,Ireland,229831,14.19,83812.8,206467,4585,23364
21/3/21,Ireland,230599,14.26,83812.8,207235,4587,23364
22/3/21,Ireland,231119,14.45,83812.8,207755,4588,23364
23/3/21,Ireland,231484,14.85,83812.8,208120,4610,23364
24/3/21,Ireland,232164,15.32,83812.8,208800,4628,23364
25/3/21,Ireland,232758,15.94,83812.8,209394,4631,23364
26/3/21,Ireland,233327,16.52,83812.8,209963,4651,23364
27/3/21,Ireland,233937,16.85,83812.8,210573,4653,23364
28/3/21,Ireland,234541,17.21,83812.8,211177,4666,23364
29/3/21,Ireland,235078,17.59,83812.8,211714,4667,23364
30/3/21,Ireland,235444,18.12,83812.8,212080,4681,23364
31/3/21,Ireland,235854,18.74,83812.8,212490,4687,23364
1/4/21,Ireland,236600,19.41,83812.8,213236,4705,23364
2/4/21,Ireland,237187,19.65,83812.8,213823,4713,23364
3/4/21,Ireland,237695,19.72,83812.8,214331,4715,23364
4/4/21,Ireland,238148,19.79,83812.8,214784,4718,23364
5/4/21,Ireland,238466,20.19,83812.8,215102,4718,23364
6/4/21,Ireland,238907,20.77,83812.8,215543,4727,23364
7/4/21,Ireland,239325,21.38,83812.8,215961,4732,23364
8/4/21,Ireland,239723,21.97,83812.8,216359,4737,23364
9/4/21,Ireland,240192,22.27,83812.8,216828,4769,23364
10/4/21,Ireland,240643,22.34,83812.8,217279,4783,23364
11/4/21,Ireland,240945,22.54,83812.8,217581,4785,23364
12/4/21,Ireland,241330,22.94,83812.8,217966,4785,23364
13/4/21,Ireland,241684,23.48,83812.8,218320,4803,23364
14/4/21,Ireland,242105,24.23,83812.8,218741,4812,23364
15/4/21,Ireland,242402,24.99,83812.8,219038,4820,23364
16/4/21,Ireland,242819,25.39,83812.8,219455,4831,23364
17/4/21,Ireland,243238,25.42,83812.8,219874,4835,23364
18/4/21,Ireland,243508,25.6,83812.8,220144,4836,23364
19/4/21,Ireland,243911,26.04,83812.8,220547,4836,23364
20/4/21,Ireland,244297,26.77,83812.8,220933,4847,23364
21/4/21,Ireland,244695,27.64,83812.8,221331,4856,23364
22/4/21,Ireland,245310,28.56,83812.8,221946,4866,23364
23/4/21,Ireland,245743,29.17,83812.8,222379,4867,23364
24/4/21,Ireland,246204,29.37,83812.8,222840,4872,23364
25/4/21,Ireland,246633,29.73,83812.8,223269,4873,23364
26/4/21,Ireland,247069,30.41,83812.8,223705,4874,23364
27/4/21,Ireland,247489,31.09,83812.8,224125,4884,23364
28/4/21,Ireland,247857,31.95,83812.8,224493,4896,23364
29/4/21,Ireland,248326,32.94,83812.8,224962,4899,23364
30/4/21,Ireland,248870,33.4,83812.8,225506,4903,23364
1/5/21,Ireland,249437,33.67,83812.8,226073,4906,23364
2/5/21,Ireland,249838,33.97,83812.8,226474,4906,23364
3/5/21,Ireland,250290,34.63,83812.8,226926,4906,23364
4/5/21,Ireland,250672,35.54,83812.8,227308,4908,23364
5/5/21,Ireland,251087,36.57,83812.8,227723,4915,23364
6/5/21,Ireland,251474,37.68,83812.8,228110,4921,23364
7/5/21,Ireland,251904,38.33,83812.8,228540,4918,23364
8/5/21,Ireland,252303,38.74,83812.8,228939,4919,23364
9/5/21,Ireland,252809,39.41,83812.8,229445,4921,23364
10/5/21,Ireland,253189,40.39,83812.8,229825,4921,23364
11/5/21,Ireland,253567,41.43,83812.8,230203,4929,23364
12/5/21,Ireland,254013,42.66,83812.8,230649,4937,23364
13/5/21,Ireland,254450,43.99,83812.8,231086,4937,23364
14/5/21,Ireland,254870,44.81,83812.8,231506,4941,23364
15/5/21,Ireland,255331,45.29,83812.8,231967,4941,23364
16/5/21,Ireland,255706,46.08,83812.8,232342,4941,23364
17/5/21,Ireland,256085,47.1,83812.8,232721,4941,23364
18/5/21,Ireland,256450,48.2,83812.8,233086,4941,23364
19/5/21,Ireland,256976,49.37,83812.8,233612,4941,23364
20/5/21,Ireland,257446,50.64,83812.8,234082,4941,23364
21/5/21,Ireland,257979,51.45,83812.8,234615,4941,23364
22/5/21,Ireland,258363,51.92,83812.8,234999,4941,23364
23/5/21,Ireland,258810,52.7,83812.8,235446,4941,23364
24/5/21,Ireland,259159,53.7,83812.8,235795,4941,23364
25/5/21,Ireland,259512,54.66,83812.8,236148,4941,23364
26/5/21,Ireland,259957,55.72,83812.8,236593,4941,23364
27/5/21,Ireland,260389,56.92,83812.8,237025,4941,23364
28/5/21,Ireland,260850,57.57,83812.8,237486,4941,23364
29/5/21,Ireland,261306,58.09,83812.8,237942,4941,23364
30/5/21,Ireland,261673,58.75,83812.8,238309,4941,23364
31/5/21,Ireland,262043,59.59,83812.8,238679,4941,23364
1/6/21,Ireland,262380,60.45,83812.8,239016,4941,23364
2/6/21,Ireland,262787,61.44,83812.8,239423,4941,23364
3/6/21,Ireland,263252,62.48,83812.8,239888,4941,23364
4/6/21,Ireland,263769,63.12,83812.8,240405,4941,23364
5/6/21,Ireland,264185,63.59,83812.8,240821,4941,23364
6/6/21,Ireland,264498,64.07,83812.8,241134,4941,23364
7/6/21,Ireland,264875,64.97,83812.8,241511,4941,23364
8/6/21,Ireland,265114,66.02,83812.8,241750,4941,23364
9/6/21,Ireland,265341,67.12,83812.8,241977,4941,23364
10/6/21,Ireland,265739,68.31,83812.8,242375,4941,23364
11/6/21,Ireland,266058,68.94,83812.8,242694,4941,23364
12/6/21,Ireland,266489,69.48,83812.8,243125,4941,23364
13/6/21,Ireland,266804,70.42,83812.8,243440,4941,23364
14/6/21,Ireland,267006,71.55,83812.8,243642,4941,23364
15/6/21,Ireland,267289,72.78,83812.8,243925,4941,23364
16/6/21,Ireland,267576,74.06,83812.8,244212,4941,23364
17/6/21,Ireland,267949,75.31,83812.8,244585,4979,23364
18/6/21,Ireland,268251,76.09,83812.8,244887,4979,23364
19/6/21,Ireland,268644,76.79,83812.8,245280,4979,23364
20/6/21,Ireland,269037,77.75,83812.8,245673,4979,23364
21/6/21,Ireland,269321,78.93,83812.8,245957,4979,23364
22/6/21,Ireland,269495,80.12,83812.8,246131,4979,23364
23/6/21,Ireland,269793,81.4,83812.8,246429,4989,23364
24/6/21,Ireland,270097,82.72,83812.8,246733,4989,23364
25/6/21,Ireland,270477,83.51,83812.8,247113,4989,23364
26/6/21,Ireland,270920,84.29,83812.8,247556,4989,23364
27/6/21,Ireland,271260,85.27,83812.8,247896,4989,23364
28/6/21,Ireland,271589,86.46,83812.8,248225,4989,23364
29/6/21,Ireland,271931,87.65,83812.8,248567,4989,23364
30/6/21,Ireland,271908,88.92,83812.8,248544,4998,23364
1/2/21,Israel,652246,54.65,43610.52,79268,4816,572978
2/2/21,Israel,659978,55.73,43610.52,77779,4887,582199
3/2/21,Israel,668874,56.93,43610.52,79793,4948,589081
4/2/21,Israel,675618,58.34,43610.52,86130,5001,589488
5/2/21,Israel,680856,59.01,43610.52,90034,5020,590822
6/2/21,Israel,685583,59.48,43610.52,76439,5071,609144
7/2/21,Israel,692101,60.8,43610.52,73001,5121,619100
8/2/21,Israel,696528,62.14,43610.52,73444,5171,623084
9/2/21,Israel,703719,63.58,43610.52,75715,5216,628004
10/2/21,Israel,709729,65.11,43610.52,73769,5257,635960
11/2/21,Israel,714812,66.76,43610.52,70109,5283,644703
12/2/21,Israel,718746,67.58,43610.52,67453,5304,651293
13/2/21,Israel,721846,68.2,43610.52,66554,5351,655292
14/2/21,Israel,724380,69.75,43610.52,60648,5388,663732
15/2/21,Israel,730293,71.44,43610.52,60042,5414,670251
16/2/21,Israel,734575,73.18,43610.52,60894,5441,673681
17/2/21,Israel,738629,74.66,43610.52,57607,5473,681022
18/2/21,Israel,741934,76.26,43610.52,53750,5509,688184
19/2/21,Israel,744513,77.09,43610.52,51010,5526,693503
20/2/21,Israel,744513,77.74,43610.52,51010,5526,693503
21/2/21,Israel,750043,79.44,43610.52,46252,5577,703791
22/2/21,Israel,754998,81.22,43610.52,45604,5596,709394
23/2/21,Israel,759572,82.81,43610.52,47244,5634,712328
24/2/21,Israel,763756,84.14,43610.52,46061,5660,717695
25/2/21,Israel,767726,85.4,43610.52,45418,5687,722308
26/2/21,Israel,770780,86.02,43610.52,45053,5697,725727
27/2/21,Israel,773335,86.44,43610.52,45759,5732,727576
28/2/21,Israel,775807,87.48,43610.52,42623,5752,733184
1/3/21,Israel,779958,88.63,43610.52,44334,5760,735624
2/3/21,Israel,785218,89.76,43610.52,46992,5790,738226
3/3/21,Israel,789485,90.93,43610.52,48544,5803,740941
4/3/21,Israel,793407,92.21,43610.52,47405,5822,746002
5/3/21,Israel,796465,92.83,43610.52,46030,5834,750435
6/3/21,Israel,799727,93.22,43610.52,46646,5856,753081
7/3/21,Israel,801575,94.33,43610.52,43034,5891,758541
8/3/21,Israel,805116,95.41,43610.52,43790,5917,761326
9/3/21,Israel,808262,96.52,43610.52,44042,5933,764220
10/3/21,Israel,811492,97.4,43610.52,42779,5950,768713
11/3/21,Israel,814250,98.4,43610.52,40705,5967,773545
12/3/21,Israel,816198,98.96,43610.52,40523,5980,775675
13/3/21,Israel,817799,99.32,43610.52,41921,5988,775878
14/3/21,Israel,818977,100.34,43610.52,33635,6011,785342
15/3/21,Israel,820913,101.39,43610.52,33020,6030,787893
16/3/21,Israel,822703,102.36,43610.52,32363,6048,790340
17/3/21,Israel,824178,103.19,43610.52,30455,6057,793723
18/3/21,Israel,825562,103.98,43610.52,27466,6069,798096
19/3/21,Israel,826609,104.36,43610.52,26095,6073,800514
20/3/21,Israel,827220,104.58,43610.52,25097,6082,802123
21/3/21,Israel,827772,105.15,43610.52,22317,6092,805455
22/3/21,Israel,828764,105.73,43610.52,21111,6109,807653
23/3/21,Israel,829689,105.84,43610.52,20820,6122,808869
24/3/21,Israel,830028,106.45,43610.52,19020,6154,811008
25/3/21,Israel,830845,106.94,43610.52,17831,6163,813014
26/3/21,Israel,831383,107.13,43610.52,16878,6165,814505
27/3/21,Israel,831383,107.19,43610.52,16878,6165,814505
28/3/21,Israel,831924,107.27,43610.52,15706,6185,816218
29/3/21,Israel,832125,107.66,43610.52,14427,6197,817698
30/3/21,Israel,832639,107.98,43610.52,14081,6193,818558
31/3/21,Israel,833105,108.28,43610.52,13440,6209,819665
1/4/21,Israel,833456,108.57,43610.52,12753,6220,820703
2/4/21,Israel,833707,108.68,43610.52,12801,6220,820906
3/4/21,Israel,834070,108.73,43610.52,12322,6236,821748
4/4/21,Israel,834247,109.08,43610.52,11460,6243,822787
5/4/21,Israel,834603,109.41,43610.52,11273,6248,823330
6/4/21,Israel,834920,109.69,43610.52,11188,6257,823732
7/4/21,Israel,835216,109.95,43610.52,11056,6266,824160
8/4/21,Israel,835486,110.23,43610.52,10738,6279,824748
9/4/21,Israel,835674,110.33,43610.52,10479,6280,825195
10/4/21,Israel,835813,110.38,43610.52,10294,6292,825519
11/4/21,Israel,835933,110.63,43610.52,9728,6296,826205
12/4/21,Israel,836158,110.87,43610.52,9664,6304,826494
13/4/21,Israel,836334,110.98,43610.52,9566,6309,826768
14/4/21,Israel,836590,111.07,43610.52,9028,6312,827562
15/4/21,Israel,836902,111.09,43610.52,8968,6315,827934
16/4/21,Israel,836936,111.19,43610.52,8701,6316,828235
17/4/21,Israel,836883,111.22,43610.52,8917,6331,827966
18/4/21,Israel,837047,111.37,43610.52,8559,6335,828488
19/4/21,Israel,837218,111.52,43610.52,8532,6341,828686
20/4/21,Israel,837357,111.66,43610.52,8455,6345,828902
21/4/21,Israel,837492,111.8,43610.52,8365,6346,829127
22/4/21,Israel,837807,111.94,43610.52,8383,6346,829424
23/4/21,Israel,837892,112.01,43610.52,8196,6346,829696
24/4/21,Israel,837974,112.03,43610.52,8163,6350,829811
25/4/21,Israel,838024,112.15,43610.52,8041,6352,829983
26/4/21,Israel,838107,112.29,43610.52,8019,6353,830088
27/4/21,Israel,838217,112.41,43610.52,8012,6359,830205
28/4/21,Israel,838323,112.53,43610.52,7949,6361,830374
29/4/21,Israel,838407,112.66,43610.52,7877,6362,830530
30/4/21,Israel,838481,112.71,43610.52,7856,6363,830625
1/5/21,Israel,838481,112.72,43610.52,7856,6363,830625
2/5/21,Israel,838554,112.82,43610.52,7676,6366,830878
3/5/21,Israel,838621,112.92,43610.52,7626,6367,830995
4/5/21,Israel,838697,113,43610.52,7607,6369,831090
5/5/21,Israel,838767,113.08,43610.52,7549,6370,831218
6/5/21,Israel,838828,113.15,43610.52,7549,6374,831279
7/5/21,Israel,838858,113.19,43610.52,7478,6375,831380
8/5/21,Israel,838886,113.2,43610.52,7454,6376,831432
9/5/21,Israel,838894,113.28,43610.52,7318,6377,831576
10/5/21,Israel,838957,113.36,43610.52,7352,6378,831605
11/5/21,Israel,839000,113.43,43610.52,7314,6378,831686
12/5/21,Israel,839030,113.48,43610.52,7256,6379,831774
13/5/21,Israel,839059,113.54,43610.52,7223,6379,831836
14/5/21,Israel,839079,113.56,43610.52,7181,6380,831898
15/5/21,Israel,839118,113.57,43610.52,7189,6381,831929
16/5/21,Israel,839119,113.58,43610.52,7099,6382,832020
17/5/21,Israel,839159,113.59,43610.52,7118,6389,832041
18/5/21,Israel,839167,113.66,43610.52,7063,6392,832104
19/5/21,Israel,839221,113.74,43610.52,7041,6395,832180
20/5/21,Israel,839263,113.8,43610.52,7020,6396,832243
21/5/21,Israel,839290,113.83,43610.52,7011,6397,832279
22/5/21,Israel,839308,113.83,43610.52,7009,6397,832299
23/5/21,Israel,839319,113.89,43610.52,6955,6404,832364
24/5/21,Israel,839367,113.95,43610.52,6976,6406,832391
25/5/21,Israel,839389,114,43610.52,6975,6406,832414
26/5/21,Israel,839408,114.03,43610.52,6951,6406,832457
27/5/21,Israel,839420,114.08,43610.52,6930,6406,832490
28/5/21,Israel,839433,114.11,43610.52,6908,6407,832525
29/5/21,Israel,839453,114.11,43610.52,6914,6407,832539
30/5/21,Israel,839458,114.15,43610.52,6867,6411,832591
31/5/21,Israel,839475,114.18,43610.52,6868,6412,832607
1/6/21,Israel,839511,114.22,43610.52,6876,6413,832635
2/6/21,Israel,839517,114.25,43610.52,6837,6415,832680
3/6/21,Israel,839532,114.28,43610.52,6720,6416,832812
4/6/21,Israel,839539,114.29,43610.52,6722,6417,832817
5/6/21,Israel,839566,114.3,43610.52,6740,6418,832826
6/6/21,Israel,839571,114.35,43610.52,6745,6418,832826
7/6/21,Israel,839585,114.4,43610.52,6709,6418,832876
8/6/21,Israel,839585,114.45,43610.52,6709,6418,832876
9/6/21,Israel,839585,114.5,43610.52,6709,6418,832876
10/6/21,Israel,839630,114.55,43610.52,6735,6428,832895
11/6/21,Israel,839653,114.57,43610.52,6748,6428,832905
12/6/21,Israel,839661,114.57,43610.52,6752,6428,832909
13/6/21,Israel,839666,114.62,43610.52,6735,6430,832931
14/6/21,Israel,839690,114.66,43610.52,6743,6428,832947
15/6/21,Israel,839701,114.71,43610.52,6752,6428,832949
16/6/21,Israel,839720,114.75,43610.52,6762,6428,832958
17/6/21,Israel,839747,114.79,43610.52,6779,6427,832968
18/6/21,Israel,839769,114.8,43610.52,6769,6427,833000
19/6/21,Israel,839830,114.8,43610.52,6818,6427,833012
20/6/21,Israel,839867,114.85,43610.52,6829,6427,833038
21/6/21,Israel,839990,114.92,43610.52,6928,6427,833062
22/6/21,Israel,840079,115,43610.52,7009,6428,833070
23/6/21,Israel,840225,115.13,43610.52,7138,6428,833087
24/6/21,Israel,840444,115.27,43610.52,7336,6429,833108
25/6/21,Israel,840638,115.35,43610.52,7517,6429,833121
26/6/21,Israel,840823,115.38,43610.52,7690,6429,833133
27/6/21,Israel,840888,115.56,43610.52,7719,6429,833169
28/6/21,Israel,841196,115.75,43610.52,7968,6429,833228
29/6/21,Israel,841486,115.97,43610.52,8193,6429,833293
30/6/21,Israel,841777,116.18,43610.52,8415,6429,833362
1/2/21,Turkey,2485182,2370431,2.51,2370431,26117,114751
2/2/21,Turkey,2492977,2379070,2.62,2379070,26237,113907
3/2/21,Turkey,2501079,2387384,2.76,2387384,26354,113695
4/2/21,Turkey,2508988,2396199,2.94,2396199,26467,112789
5/2/21,Turkey,2516889,2404416,3.01,2404416,26577,112473
6/2/21,Turkey,2524786,2412505,3.06,2412505,26685,112281
7/2/21,Turkey,2531456,2420706,3.07,2420706,26797,110750
8/2/21,Turkey,2539559,2429273,3.13,2429273,26900,110286
9/2/21,Turkey,2548195,2437382,3.21,2437382,26998,110813
10/2/21,Turkey,2556837,2445285,3.29,2445285,27093,111552
11/2/21,Turkey,2564427,2453096,3.35,2453096,27187,111331
12/2/21,Turkey,2572190,2461204,4,2461204,27284,110986
13/2/21,Turkey,2579896,2468419,4.36,2468419,27377,111477
14/2/21,Turkey,2586183,2475329,4.5,2475329,27471,110854
15/2/21,Turkey,2594128,2482435,4.92,2482435,27562,111693
16/2/21,Turkey,2602034,2489624,5.45,2489624,27652,112410
17/2/21,Turkey,2609359,2496833,6.14,2496833,27738,112526
18/2/21,Turkey,2616600,2504050,6.93,2504050,27821,112550
19/2/21,Turkey,2624019,2511548,7.48,2511548,27903,112471
20/2/21,Turkey,2631876,2518758,7.68,2518758,27983,113118
21/2/21,Turkey,2638422,2523760,7.73,2523760,28060,114662
22/2/21,Turkey,2646526,2529450,8.04,2529450,28138,117076
23/2/21,Turkey,2655633,2534996,8.57,2534996,28213,120637
24/2/21,Turkey,2665194,2540293,8.96,2540293,28285,124901
25/2/21,Turkey,2674766,2546503,9.38,2546503,28358,128263
26/2/21,Turkey,2683971,2556785,9.76,2556785,28432,127186
27/2/21,Turkey,2693164,2565723,10.01,2565723,28503,127441
28/2/21,Turkey,2701588,2572234,10.05,2572234,28569,129354
1/3/21,Turkey,2711479,2578181,10.32,2578181,28638,133298
2/3/21,Turkey,2723316,2586073,10.67,2586073,28706,137243
3/3/21,Turkey,2734836,2593264,10.96,2593264,28771,141572
4/3/21,Turkey,2746158,2601137,11.24,2601137,28839,145021
5/3/21,Turkey,2757460,2608848,11.47,2608848,28901,148612
6/3/21,Turkey,2769230,2616139,11.62,2616139,28965,153091
7/3/21,Turkey,2780417,2623924,11.66,2623924,29030,156493
8/3/21,Turkey,2793632,2632030,11.76,2632030,29094,161602
9/3/21,Turkey,2807387,2640669,12.02,2640669,29160,166718
10/3/21,Turkey,2821943,2649862,12.18,2649862,29227,172081
11/3/21,Turkey,2835989,2659093,12.35,2659093,29290,176896
12/3/21,Turkey,2850930,2670273,12.63,2670273,29356,180657
13/3/21,Turkey,2866012,2685560,12.84,2685560,29421,180452
14/3/21,Turkey,2879390,2701076,12.93,2701076,29489,178314
15/3/21,Turkey,2894893,2716969,13.24,2716969,29552,177924
16/3/21,Turkey,2911642,2734862,13.75,2734862,29623,176780
17/3/21,Turkey,2930554,2752023,14.28,2752023,29696,178531
18/3/21,Turkey,2950603,2770638,14.62,2770638,29777,179965
19/3/21,Turkey,2971633,2788757,15.1,2788757,29864,182876
20/3/21,Turkey,2992694,2807572,15.32,2807572,29959,185122
21/3/21,Turkey,3013122,2825187,15.35,2825187,30061,187935
22/3/21,Turkey,3035338,2844681,15.6,2844681,30178,190657
23/3/21,Turkey,3061520,2863882,15.98,2863882,30316,197638
24/3/21,Turkey,3091282,2881643,16.43,2881643,30462,209639
25/3/21,Turkey,3120013,2900829,16.73,2900829,30619,219184
26/3/21,Turkey,3149094,2921037,17.04,2921037,30772,228057
27/3/21,Turkey,3179115,2939929,17.23,2939929,30923,239186
28/3/21,Turkey,3208173,2957093,17.41,2957093,31076,251080
29/3/21,Turkey,3240577,2975108,17.58,2975108,31230,265469
30/3/21,Turkey,3277880,2995033,17.99,2995033,31385,282847
31/3/21,Turkey,3317182,3014226,18.62,3014226,31537,302956
1/4/21,Turkey,3357988,3035043,18.99,3035043,31713,322945
2/4/21,Turkey,3400296,3059462,19.19,3059462,31892,340834
3/4/21,Turkey,3445052,3082676,19.52,3082676,32078,362376
4/4/21,Turkey,3487050,3105350,19.62,3105350,32263,381700
5/4/21,Turkey,3529601,3130977,19.98,3130977,32456,398624
6/4/21,Turkey,3579185,3159475,20.42,3159475,32667,419710
7/4/21,Turkey,3633925,3194978,20.82,3194978,32943,438947
8/4/21,Turkey,3689866,3232892,21.27,3232892,33201,456974
9/4/21,Turkey,3745657,3268678,21.54,3268678,33454,476979
10/4/21,Turkey,3798333,3301217,21.69,3301217,33702,497116
11/4/21,Turkey,3849011,3331411,21.75,3331411,33939,517600
12/4/21,Turkey,3903573,3372629,22.02,3372629,34182,530944
13/4/21,Turkey,3962760,3424733,22.42,3424733,34455,538027
14/4/21,Turkey,4025557,3480146,22.66,3480146,34734,545411
15/4/21,Turkey,4086957,3535040,22.87,3535040,35031,551917
16/4/21,Turkey,4150039,3591550,23.3,3591550,35320,558489
17/4/21,Turkey,4212645,3643734,23.44,3643734,35608,568911
18/4/21,Turkey,4268447,3687590,23.48,3687590,35926,580857
19/4/21,Turkey,4323596,3736537,23.61,3736537,36267,587059
20/4/21,Turkey,4384624,3792129,23.85,3792129,36613,592495
21/4/21,Turkey,4446591,3844342,24.08,3844342,36975,602249
22/4/21,Turkey,4501382,3909935,24.37,3909935,37329,591447
23/4/21,Turkey,4550820,3970111,24.56,3970111,37672,580709
24/4/21,Turkey,4591416,4022408,24.77,4022408,38011,569008
25/4/21,Turkey,4629969,4073644,24.85,4073644,38358,556325
26/4/21,Turkey,4667281,4121671,25.16,4121671,38711,545610
27/4/21,Turkey,4710582,4167263,25.49,4167263,39057,543319
28/4/21,Turkey,4751026,4212461,26.03,4212461,39398,538565
29/4/21,Turkey,4788700,4255714,26.54,4255714,39737,532986
30/4/21,Turkey,4820591,4323897,26.83,4323897,40131,496694
1/5/21,Turkey,4849408,4405199,26.93,4405199,40504,444209
2/5/21,Turkey,4875388,4480381,27.05,4480381,40844,395007
3/5/21,Turkey,4900121,4515819,27.39,4515819,41191,384302
4/5/21,Turkey,4929118,4554037,27.9,4554037,41527,375081
5/5/21,Turkey,4955594,4589501,28.34,4589501,41883,366093
6/5/21,Turkey,4977982,4626799,28.77,4626799,42187,351183
7/5/21,Turkey,4998089,4662328,29.03,4662328,42465,335761
8/5/21,Turkey,5016141,4691224,29.22,4691224,42746,324917
9/5/21,Turkey,5031332,4716918,29.3,4716918,43029,314414
10/5/21,Turkey,5044936,4743871,29.42,4743871,43311,301065
11/5/21,Turkey,5059433,4766124,29.61,4766124,43589,293309
12/5/21,Turkey,5072462,4801291,29.81,4801291,43821,271171
13/5/21,Turkey,5083996,4856763,29.87,4856763,44059,227233
14/5/21,Turkey,5095390,4894024,30.06,4894024,44301,201366
15/5/21,Turkey,5106862,4932838,30.21,4932838,44537,174024
16/5/21,Turkey,5117374,4947256,30.31,4947256,44760,170118
17/5/21,Turkey,5127548,4961120,30.52,4961120,44983,166428
18/5/21,Turkey,5139485,4971245,31.2,4971245,45186,168240
19/5/21,Turkey,5151038,4980516,31.54,4980516,45419,170522
20/5/21,Turkey,5160423,4989787,31.85,4989787,45626,170636
21/5/21,Turkey,5169951,4998639,32.63,4998639,45840,171312
22/5/21,Turkey,5178648,5013111,32.71,5013111,46071,165537
23/5/21,Turkey,5186487,5024313,32.98,5024313,46268,162174
24/5/21,Turkey,5194010,5034316,33.11,5034316,46446,159694
25/5/21,Turkey,5203385,5045508,33.39,5045508,46621,157877
26/5/21,Turkey,5212123,5057713,33.53,5057713,46787,154410
27/5/21,Turkey,5220549,5070815,33.64,5070815,46970,149734
28/5/21,Turkey,5228322,5083099,33.78,5083099,47134,145223
29/5/21,Turkey,5235978,5094279,33.87,5094279,47271,141699
30/5/21,Turkey,5242911,5105042,34.05,5105042,47405,137869
31/5/21,Turkey,5249404,5114624,34.3,5114624,47527,134780
1/6/21,Turkey,5256516,5124081,34.54,5124081,47656,132435
2/6/21,Turkey,5263697,5131453,34.87,5131453,47768,132244
3/6/21,Turkey,5270299,5139993,35.43,5139993,47882,130306
4/6/21,Turkey,5276468,5147610,35.65,5147610,47976,128858
5/6/21,Turkey,5282594,5154771,35.95,5154771,48068,127823
6/6/21,Turkey,5287980,5160774,36.28,5160774,48164,127206
7/6/21,Turkey,5293627,5167350,36.74,5167350,48255,126277
8/6/21,Turkey,5300236,5173186,37.15,5173186,48341,127050
9/6/21,Turkey,5306690,5179833,37.61,5179833,48428,126857
10/6/21,Turkey,5313098,5186728,38.22,5186728,48524,126370
11/6/21,Turkey,5319359,5192945,38.75,5192945,48593,126414
12/6/21,Turkey,5325435,5198057,39.31,5198057,48668,127378
13/6/21,Turkey,5330447,5202251,40.04,5202251,48721,128196
14/6/21,Turkey,5336073,5206836,40.89,5206836,48795,129237
15/6/21,Turkey,5342028,5211022,42.62,5211022,48879,131006
16/6/21,Turkey,5348249,5215654,44.38,5215654,48950,132595
17/6/21,Turkey,5354153,5219797,46.38,5219797,49012,134356
18/6/21,Turkey,5359728,5224224,47.76,5224224,49071,135504
19/6/21,Turkey,5365208,5228419,48.44,5228419,49122,136789
20/6/21,Turkey,5370299,5232638,50.11,5232638,49185,137661
21/6/21,Turkey,5375593,5237731,51.3,5237731,49236,137862
22/6/21,Turkey,5381736,5242945,51.83,5242945,49293,138791
23/6/21,Turkey,5387545,5248862,52.86,5248862,49358,138683
24/6/21,Turkey,5393248,5254708,53.89,5254708,49417,138540
25/6/21,Turkey,5398878,5261892,54.84,5261892,49473,136986
26/6/21,Turkey,5404144,5269294,55.36,5269294,49524,134850
27/6/21,Turkey,5409027,5275231,56.18,5275231,49576,133796
28/6/21,Turkey,5414310,5280558,57.55,5280558,49634,133752
29/6/21,Turkey,5420156,5287094,58.09,5287094,49687,133062
30/6/21,Turkey,5425652,5294285,59.51,5294285,49732,131367
1/2/21,Latvia,66652,1.36,17619.95,11727,1202,54925
2/2/21,Latvia,67427,1.46,17619.95,11719,1219,55708
3/2/21,Latvia,68658,1.55,17619.95,12950,1250,55708
4/2/21,Latvia,69400,1.63,17619.95,13692,1281,55708
5/2/21,Latvia,70276,1.72,17619.95,12623,1309,57653
6/2/21,Latvia,71320,1.75,17619.95,11921,1327,59399
7/2/21,Latvia,71800,1.76,17619.95,11903,1339,59897
8/2/21,Latvia,72088,1.78,17619.95,11971,1347,60117
9/2/21,Latvia,72869,1.79,17619.95,12071,1363,60798
10/2/21,Latvia,73859,1.82,17619.95,11970,1395,61889
11/2/21,Latvia,74701,1.92,17619.95,11857,1416,62844
12/2/21,Latvia,75509,2.02,17619.95,12665,1431,62844
13/2/21,Latvia,76282,2.04,17619.95,11754,1443,64528
14/2/21,Latvia,76706,2.04,17619.95,11660,1451,65046
15/2/21,Latvia,76984,2.09,17619.95,11534,1468,65450
16/2/21,Latvia,77697,2.16,17619.95,12247,1486,65450
17/2/21,Latvia,78643,2.27,17619.95,12435,1508,66208
18/2/21,Latvia,79351,2.35,17619.95,11232,1521,68119
19/2/21,Latvia,80040,2.43,17619.95,11073,1533,68967
20/2/21,Latvia,81109,2.47,17619.95,11116,1538,69993
21/2/21,Latvia,81519,2.51,17619.95,11526,1542,69993
22/2/21,Latvia,81793,2.61,17619.95,11052,1546,70741
23/2/21,Latvia,82462,2.74,17619.95,10956,1570,71506
24/2/21,Latvia,83445,2.97,17619.95,10983,1587,72462
25/2/21,Latvia,84258,3.2,17619.95,10973,1593,73285
26/2/21,Latvia,84983,3.38,17619.95,10905,1601,74078
27/2/21,Latvia,85810,3.41,17619.95,10971,1614,74839
28/2/21,Latvia,86186,3.42,17619.95,10931,1618,75255
1/3/21,Latvia,86458,3.52,17619.95,11203,1621,75255
2/3/21,Latvia,87103,3.63,17619.95,10892,1638,76211
3/3/21,Latvia,88022,3.86,17619.95,10887,1654,77135
4/3/21,Latvia,88668,4.19,17619.95,10838,1666,77830
5/3/21,Latvia,89414,4.45,17619.95,10907,1680,78507
6/3/21,Latvia,90009,4.49,17619.95,11502,1687,78507
7/3/21,Latvia,90331,4.5,17619.95,11824,1695,78507
8/3/21,Latvia,90525,4.59,17619.95,10278,1699,80247
9/3/21,Latvia,90997,4.72,17619.95,10105,1705,80892
10/3/21,Latvia,91636,4.85,17619.95,9778,1726,81858
11/3/21,Latvia,92274,5,17619.95,9609,1737,82665
12/3/21,Latvia,92906,5.27,17619.95,9524,1746,83382
13/3/21,Latvia,93484,5.32,17619.95,9288,1757,84196
14/3/21,Latvia,93781,5.33,17619.95,9213,1767,84568
15/3/21,Latvia,93959,5.53,17619.95,9122,1769,84837
16/3/21,Latvia,94602,5.54,17619.95,9137,1777,85465
17/3/21,Latvia,95420,5.55,17619.95,9955,1789,85465
18/3/21,Latvia,95902,5.57,17619.95,10437,1801,85465
19/3/21,Latvia,96524,5.61,17619.95,8790,1811,87734
20/3/21,Latvia,97149,5.64,17619.95,8827,1821,88322
21/3/21,Latvia,97409,5.64,17619.95,9087,1826,88322
22/3/21,Latvia,97586,5.78,17619.95,9264,1828,88322
23/3/21,Latvia,98094,6.09,17619.95,9772,1840,88322
24/3/21,Latvia,98870,6.42,17619.95,8960,1851,89910
25/3/21,Latvia,99476,6.72,17619.95,8939,1864,90537
26/3/21,Latvia,100114,6.93,17619.95,9577,1867,90537
27/3/21,Latvia,100716,6.97,17619.95,8989,1872,91727
28/3/21,Latvia,101040,6.97,17619.95,9026,1878,92014
29/3/21,Latvia,101207,7.08,17619.95,9017,1883,92190
30/3/21,Latvia,101733,7.36,17619.95,8908,1893,92825
31/3/21,Latvia,102363,7.67,17619.95,8732,1899,93631
1/4/21,Latvia,103001,7.9,17619.95,9370,1913,93631
2/4/21,Latvia,103588,7.93,17619.95,9487,1922,94101
3/4/21,Latvia,103867,8.11,17619.95,9766,1923,94101
4/4/21,Latvia,104105,8.2,17619.95,10004,1931,94101
5/4/21,Latvia,104224,8.36,17619.95,8663,1934,95561
6/4/21,Latvia,104533,8.65,17619.95,8775,1937,95758
7/4/21,Latvia,105176,9.15,17619.95,8922,1946,96254
8/4/21,Latvia,105916,9.53,17619.95,8897,1963,97019
9/4/21,Latvia,106574,9.8,17619.95,8962,1981,97612
10/4/21,Latvia,107240,9.89,17619.95,8993,1986,98247
11/4/21,Latvia,107608,9.89,17619.95,8446,1986,99162
12/4/21,Latvia,107818,10.03,17619.95,8494,1990,99324
13/4/21,Latvia,108355,10.23,17619.95,8515,2002,99840
14/4/21,Latvia,109088,10.57,17619.95,9248,2019,99840
15/4/21,Latvia,109731,10.89,17619.95,8643,2030,101088
16/4/21,Latvia,110343,11.38,17619.95,9255,2042,101088
17/4/21,Latvia,110997,11.72,17619.95,9053,2048,101944
18/4/21,Latvia,111334,11.77,17619.95,9390,2053,101944
19/4/21,Latvia,111536,11.98,17619.95,9362,2056,102174
20/4/21,Latvia,112224,12.38,17619.95,9934,2071,102290
21/4/21,Latvia,112983,12.93,17619.95,10387,2079,102596
22/4/21,Latvia,113561,13.46,17619.95,10331,2088,103230
23/4/21,Latvia,114244,14.04,17619.95,10291,2094,103953
24/4/21,Latvia,114955,14.38,17619.95,11002,2101,103953
25/4/21,Latvia,115316,14.45,17619.95,10062,2102,105254
26/4/21,Latvia,115536,14.7,17619.95,9914,2106,105622
27/4/21,Latvia,116132,15.1,17619.95,10304,2110,105828
28/4/21,Latvia,117099,15.89,17619.95,10746,2118,106353
29/4/21,Latvia,117795,16.67,17619.95,10726,2125,107069
30/4/21,Latvia,118558,17.29,17619.95,10857,2131,107701
1/5/21,Latvia,119370,17.66,17619.95,10421,2139,108949
2/5/21,Latvia,119750,17.74,17619.95,10801,2144,108949
3/5/21,Latvia,119953,17.9,17619.95,10672,2154,109281
4/5/21,Latvia,120378,18.38,17619.95,10225,2159,110153
5/5/21,Latvia,120736,19.27,17619.95,10583,2166,110153
6/5/21,Latvia,121509,20.44,17619.95,10605,2178,110904
7/5/21,Latvia,122545,21.51,17619.95,11072,2197,111473
8/5/21,Latvia,123331,22.17,17619.95,11181,2208,112150
9/5/21,Latvia,123963,22.26,17619.95,10749,2212,113214
10/5/21,Latvia,124301,22.77,17619.95,11087,2213,113214
11/5/21,Latvia,124960,23.73,17619.95,11530,2217,113430
12/5/21,Latvia,125689,24.94,17619.95,10708,2223,114981
13/5/21,Latvia,126378,26.13,17619.95,11397,2240,114981
14/5/21,Latvia,127053,27.28,17619.95,11383,2248,115670
15/5/21,Latvia,127597,28,17619.95,11170,2257,116427
16/5/21,Latvia,127978,28.27,17619.95,10747,2266,117231
17/5/21,Latvia,128125,28.9,17619.95,10326,2269,117799
18/5/21,Latvia,128688,29.81,17619.95,10889,2280,117799
19/5/21,Latvia,129297,31.02,17619.95,11078,2298,118219
20/5/21,Latvia,129794,32.14,17619.95,11044,2301,118750
21/5/21,Latvia,130271,33.23,17619.95,9923,2309,120348
22/5/21,Latvia,130712,33.9,17619.95,9589,2323,121123
23/5/21,Latvia,130945,34.05,17619.95,9822,2326,121123
24/5/21,Latvia,131079,34.69,17619.95,8991,2328,122088
25/5/21,Latvia,131514,35.79,17619.95,9426,2342,122088
26/5/21,Latvia,131910,36.97,17619.95,9167,2348,122743
27/5/21,Latvia,132258,38.14,17619.95,8792,2355,123466
28/5/21,Latvia,132612,39.47,17619.95,8465,2359,124147
29/5/21,Latvia,132918,40.11,17619.95,7578,2370,125340
30/5/21,Latvia,133098,40.33,17619.95,7758,2370,125340
31/5/21,Latvia,133199,41.03,17619.95,7487,2376,125712
1/6/21,Latvia,133518,42.17,17619.95,7662,2379,125856
2/6/21,Latvia,133866,43.35,17619.95,6867,2386,126999
3/6/21,Latvia,134162,44.52,17619.95,7163,2392,126999
4/6/21,Latvia,134421,45.6,17619.95,6928,2402,127493
5/6/21,Latvia,134677,46.2,17619.95,6715,2407,127962
6/6/21,Latvia,134812,46.48,17619.95,6193,2413,128619
7/6/21,Latvia,134888,47.28,17619.95,6269,2413,128619
8/6/21,Latvia,135144,48.25,17619.95,6393,2423,128751
9/6/21,Latvia,135388,49.23,17619.95,6216,2428,129172
10/6/21,Latvia,135584,50.15,17619.95,5681,2443,129903
11/6/21,Latvia,135762,51.08,17619.95,5509,2449,130253
12/6/21,Latvia,135940,51.52,17619.95,5392,2451,130548
13/6/21,Latvia,136030,51.61,17619.95,5302,2456,130728
14/6/21,Latvia,136104,52.17,17619.95,5281,2456,130823
15/6/21,Latvia,136247,52.86,17619.95,5424,2464,130823
16/6/21,Latvia,136403,53.72,17619.95,4923,2475,131480
17/6/21,Latvia,136544,54.43,17619.95,5064,2482,131480
18/6/21,Latvia,136652,55.36,17619.95,4633,2485,132019
19/6/21,Latvia,136736,55.81,17619.95,4717,2493,132019
20/6/21,Latvia,136810,56,17619.95,4540,2496,132270
21/6/21,Latvia,136850,56.67,17619.95,4129,2496,132721
22/6/21,Latvia,136975,57.22,17619.95,4254,2497,132721
23/6/21,Latvia,137077,57.24,17619.95,4356,2497,132721
24/6/21,Latvia,137110,57.25,17619.95,4150,2500,132960
25/6/21,Latvia,137130,57.41,17619.95,3817,2501,133313
26/6/21,Latvia,137169,57.59,17619.95,3680,2503,133489
27/6/21,Latvia,137210,57.71,17619.95,3721,2503,133489
28/6/21,Latvia,137240,58.54,17619.95,3592,2503,133648
29/6/21,Latvia,137329,59.32,17619.95,3681,2508,133648
30/6/21,Latvia,137429,60.11,17619.95,3501,2513,133928
1/2/21,Switzerland,525095,3.72,86601.56,207495,9558,317600
2/2/21,Switzerland,526728,3.95,86601.56,209128,9584,317600
3/2/21,Switzerland,528524,4.17,86601.56,210924,9605,317600
4/2/21,Switzerland,530289,4.41,86601.56,212689,9635,317600
5/2/21,Switzerland,531873,4.63,86601.56,214273,9658,317600
6/2/21,Switzerland,531873,4.67,86601.56,214273,9688,317600
7/2/21,Switzerland,531873,4.68,86601.56,214273,9716,317600
8/2/21,Switzerland,535153,4.9,86601.56,217553,9629,317600
9/2/21,Switzerland,536516,5.19,86601.56,218916,9760,317600
10/2/21,Switzerland,538118,5.5,86601.56,220518,9785,317600
11/2/21,Switzerland,539474,5.82,86601.56,221874,9799,317600
12/2/21,Switzerland,540727,6.13,86601.56,223127,9815,317600
13/2/21,Switzerland,540727,6.21,86601.56,223127,9835,317600
14/2/21,Switzerland,540727,6.22,86601.56,223127,9853,317600
15/2/21,Switzerland,543207,6.44,86601.56,225607,9872,317600
16/2/21,Switzerland,544282,6.73,86601.56,226682,9881,317600
17/2/21,Switzerland,545535,7.01,86601.56,227935,9903,317600
18/2/21,Switzerland,546754,7.34,86601.56,229154,9913,317600
19/2/21,Switzerland,547775,7.62,86601.56,230175,9925,317600
20/2/21,Switzerland,547775,7.71,86601.56,230175,9935,317600
21/2/21,Switzerland,547775,7.72,86601.56,230175,9946,317600
22/2/21,Switzerland,550224,7.96,86601.56,232624,9958,317600
23/2/21,Switzerland,551355,8.26,86601.56,233755,9969,317600
24/2/21,Switzerland,552698,8.59,86601.56,235098,9980,317600
25/2/21,Switzerland,553867,8.93,86601.56,236267,9994,317600
26/2/21,Switzerland,554932,9.22,86601.56,237332,10002,317600
27/2/21,Switzerland,554932,9.29,86601.56,237332,10009,317600
28/2/21,Switzerland,554932,9.31,86601.56,237332,10016,317600
1/3/21,Switzerland,557492,9.57,86601.56,239892,10027,317600
2/3/21,Switzerland,558622,9.87,86601.56,241022,10035,317600
3/3/21,Switzerland,559845,10.23,86601.56,242245,10043,317600
4/3/21,Switzerland,561068,10.62,86601.56,243468,10049,317600
5/3/21,Switzerland,562290,10.96,86601.56,244690,10059,317600
6/3/21,Switzerland,562290,11.03,86601.56,244690,10067,317600
7/3/21,Switzerland,562290,11.06,86601.56,244690,10074,317600
8/3/21,Switzerland,565034,11.33,86601.56,247434,10083,317600
9/3/21,Switzerland,566412,11.68,86601.56,248812,10093,317600
10/3/21,Switzerland,567903,12.03,86601.56,250303,10105,317600
11/3/21,Switzerland,569312,12.4,86601.56,251712,10113,317600
12/3/21,Switzerland,570645,12.72,86601.56,253045,10120,317600
13/3/21,Switzerland,570645,12.79,86601.56,253045,10132,317600
14/3/21,Switzerland,570645,12.8,86601.56,253045,10143,317600
15/3/21,Switzerland,573815,13.04,86601.56,256215,10152,317600
16/3/21,Switzerland,575253,13.38,86601.56,257653,10164,317600
17/3/21,Switzerland,577111,13.75,86601.56,259511,10175,317600
18/3/21,Switzerland,578861,14.13,86601.56,261261,10181,317600
19/3/21,Switzerland,580609,14.45,86601.56,263009,10189,317600
20/3/21,Switzerland,580609,14.52,86601.56,263009,10195,317600
21/3/21,Switzerland,580609,14.54,86601.56,263009,10202,317600
22/3/21,Switzerland,584252,14.83,86601.56,266652,10207,317600
23/3/21,Switzerland,586096,15.2,86601.56,268496,10219,317600
24/3/21,Switzerland,588118,15.61,86601.56,270518,10229,317600
25/3/21,Switzerland,590164,16.06,86601.56,272564,10241,317600
26/3/21,Switzerland,592217,16.48,86601.56,274617,10245,317600
27/3/21,Switzerland,592217,16.59,86601.56,274617,10255,317600
28/3/21,Switzerland,592217,16.63,86601.56,274617,10264,317600
29/3/21,Switzerland,596790,17.02,86601.56,279190,10271,317600
30/3/21,Switzerland,598713,17.5,86601.56,281113,10285,317600
31/3/21,Switzerland,601124,17.95,86601.56,283524,10297,317600
1/4/21,Switzerland,603092,18.43,86601.56,285492,10308,317600
2/4/21,Switzerland,605342,18.55,86601.56,287742,10313,317600
3/4/21,Switzerland,605342,18.62,86601.56,287742,10323,317600
4/4/21,Switzerland,605342,18.64,86601.56,287742,10331,317600
5/4/21,Switzerland,605342,18.71,86601.56,287742,10351,317600
6/4/21,Switzerland,610274,19.15,86601.56,292674,10365,317600
7/4/21,Switzerland,612575,19.69,86601.56,294975,10378,317600
8/4/21,Switzerland,615024,20.29,86601.56,297424,10383,317600
9/4/21,Switzerland,617543,20.84,86601.56,299943,10388,317600
10/4/21,Switzerland,617543,21.01,86601.56,299943,10392,317600
11/4/21,Switzerland,617543,21.06,86601.56,299943,10401,317600
12/4/21,Switzerland,623126,21.57,86601.56,305526,10406,317600
13/4/21,Switzerland,625367,22.2,86601.56,307767,10412,317600
14/4/21,Switzerland,627968,22.86,86601.56,310368,10422,317600
15/4/21,Switzerland,630194,23.53,86601.56,312594,10425,317600
16/4/21,Switzerland,632399,24.17,86601.56,314799,10431,317600
17/4/21,Switzerland,632399,24.38,86601.56,314799,10441,317600
18/4/21,Switzerland,632399,24.45,86601.56,314799,10446,317600
19/4/21,Switzerland,637304,25.05,86601.56,319704,10458,317600
20/4/21,Switzerland,639445,25.79,86601.56,321845,10465,317600
21/4/21,Switzerland,642131,26.58,86601.56,324531,10472,317600
22/4/21,Switzerland,644396,27.44,86601.56,326796,10476,317600
23/4/21,Switzerland,646509,28.21,86601.56,328909,10490,317600
24/4/21,Switzerland,646509,28.53,86601.56,328909,10495,317600
25/4/21,Switzerland,646509,28.67,86601.56,328909,10504,317600
26/4/21,Switzerland,651822,29.33,86601.56,334222,10513,317600
27/4/21,Switzerland,653957,30.19,86601.56,336357,10529,317600
28/4/21,Switzerland,656077,31.04,86601.56,338477,10537,317600
29/4/21,Switzerland,658143,31.88,86601.56,340543,10544,317600
30/4/21,Switzerland,659974,32.63,86601.56,342374,10555,317600
1/5/21,Switzerland,659974,32.98,86601.56,342374,10565,317600
2/5/21,Switzerland,659974,33.12,86601.56,342374,10571,317600
3/5/21,Switzerland,663952,33.83,86601.56,346352,10578,317600
4/5/21,Switzerland,665585,34.71,86601.56,347985,10582,317600
5/5/21,Switzerland,667380,35.62,86601.56,349780,10593,317600
6/5/21,Switzerland,669067,36.66,86601.56,351467,10598,317600
7/5/21,Switzerland,670613,37.66,86601.56,353013,10608,317600
8/5/21,Switzerland,670613,38.12,86601.56,353013,10612,317600
9/5/21,Switzerland,670613,38.31,86601.56,353013,10618,317600
10/5/21,Switzerland,674296,39.25,86601.56,356696,10621,317600
11/5/21,Switzerland,675671,40.36,86601.56,358071,10625,317600
12/5/21,Switzerland,677210,41.49,86601.56,359610,10628,317600
13/5/21,Switzerland,677210,42.02,86601.56,359610,10632,317600
14/5/21,Switzerland,679510,42.97,86601.56,361910,10637,317600
15/5/21,Switzerland,679510,43.47,86601.56,361910,10639,317600
16/5/21,Switzerland,679510,43.69,86601.56,361910,10647,317600
17/5/21,Switzerland,682160,44.67,86601.56,364560,10650,317600
18/5/21,Switzerland,683400,45.84,86601.56,365800,10654,317600
19/5/21,Switzerland,684954,47.03,86601.56,367354,10660,317600
20/5/21,Switzerland,686152,48.3,86601.56,368552,10663,317600
21/5/21,Switzerland,686152,49.48,86601.56,368552,10671,317600
22/5/21,Switzerland,687353,50.03,86601.56,369753,10681,317600
23/5/21,Switzerland,687353,50.24,86601.56,369753,10684,317600
24/5/21,Switzerland,687353,50.82,86601.56,369753,10688,317600
25/5/21,Switzerland,690123,52,86601.56,372523,10692,317600
26/5/21,Switzerland,691119,53.25,86601.56,373519,10693,317600
27/5/21,Switzerland,692111,54.5,86601.56,374511,10700,317600
28/5/21,Switzerland,693023,55.72,86601.56,375423,10705,317600
29/5/21,Switzerland,693023,56.35,86601.56,375423,10710,317600
30/5/21,Switzerland,693023,56.63,86601.56,375423,10710,317600
31/5/21,Switzerland,694740,57.71,86601.56,377140,10712,317600
1/6/21,Switzerland,695496,58.97,86601.56,377896,10712,317600
2/6/21,Switzerland,696213,60.28,86601.56,378613,10715,317600
3/6/21,Switzerland,696801,61.48,86601.56,379201,10721,317600
4/6/21,Switzerland,697292,62.76,86601.56,379692,10726,317600
5/6/21,Switzerland,697292,63.61,86601.56,379692,10728,317600
6/6/21,Switzerland,697292,63.93,86601.56,379692,10732,317600
7/6/21,Switzerland,698369,65.11,86601.56,380769,10734,317600
8/6/21,Switzerland,698798,66.41,86601.56,381198,10738,317600
9/6/21,Switzerland,698798,67.72,86601.56,381198,10741,317600
10/6/21,Switzerland,699697,68.94,86601.56,382097,10745,317600
11/6/21,Switzerland,700051,70.2,86601.56,382451,10747,317600
12/6/21,Switzerland,700051,71.01,86601.56,382451,10748,317600
13/6/21,Switzerland,700051,71.32,86601.56,382451,10749,317600
14/6/21,Switzerland,700735,72.46,86601.56,383135,10749,317600
15/6/21,Switzerland,700978,73.67,86601.56,383378,10752,317600
16/6/21,Switzerland,701260,74.86,86601.56,383660,10757,317600
17/6/21,Switzerland,701454,76.1,86601.56,383854,10759,317600
18/6/21,Switzerland,701627,77.29,86601.56,384027,10761,317600
19/6/21,Switzerland,701627,78.01,86601.56,384027,10762,317600
20/6/21,Switzerland,701627,78.25,86601.56,384027,10764,317600
21/6/21,Switzerland,701994,79.26,86601.56,384394,10764,317600
22/6/21,Switzerland,702124,80.33,86601.56,384524,10765,317600
23/6/21,Switzerland,702278,81.37,86601.56,384678,10766,317600
24/6/21,Switzerland,702398,82.4,86601.56,384798,10769,317600
25/6/21,Switzerland,702507,83.41,86601.56,384907,10771,317600
26/6/21,Switzerland,702507,84,86601.56,384907,10771,317600
27/6/21,Switzerland,702507,84.21,86601.56,384907,10773,317600
28/6/21,Switzerland,702746,85.08,86601.56,385146,10773,317600
29/6/21,Switzerland,702875,85.99,86601.56,385275,10773,317600
30/6/21,Switzerland,703004,86.95,86601.56,385404,10773,317600
1/2/21,Lithuania,182898,3.63,19997.59,19135,2830,163763
2/2/21,Lithuania,183444,3.78,19997.59,18345,2847,165099
3/2/21,Lithuania,184208,4.03,19997.59,18044,2867,166164
4/2/21,Lithuania,184948,4.4,19997.59,16580,2885,168368
5/2/21,Lithuania,185601,4.67,19997.59,16898,2908,168703
6/2/21,Lithuania,186278,4.7,19997.59,17388,2927,168890
7/2/21,Lithuania,186770,4.7,19997.59,16430,2937,170340
8/2/21,Lithuania,187039,4.8,19997.59,15759,2955,171280
9/2/21,Lithuania,187421,4.91,19997.59,15058,2972,172363
10/2/21,Lithuania,187991,5.14,19997.59,14828,2988,173163
11/2/21,Lithuania,189058,5.48,19997.59,14274,3013,174784
12/2/21,Lithuania,189665,5.75,19997.59,14722,3038,174943
13/2/21,Lithuania,190241,5.77,19997.59,15207,3057,175034
14/2/21,Lithuania,190724,5.77,19997.59,48411,3070,142313
15/2/21,Lithuania,190937,5.94,19997.59,15903,3080,175034
16/2/21,Lithuania,191264,5.96,19997.59,15986,3095,175278
17/2/21,Lithuania,191821,6.27,19997.59,15150,3113,176671
18/2/21,Lithuania,192193,6.7,19997.59,15268,3129,176925
19/2/21,Lithuania,192986,7.09,19997.59,14860,3145,178126
20/2/21,Lithuania,193562,7.12,19997.59,14198,3162,179364
21/2/21,Lithuania,194051,7.12,19997.59,14542,3171,179509
22/2/21,Lithuania,194333,7.33,19997.59,14709,3178,179624
23/2/21,Lithuania,194833,7.65,19997.59,14193,3189,180640
24/2/21,Lithuania,195481,8.09,19997.59,14251,3200,181230
25/2/21,Lithuania,196049,8.53,19997.59,14240,3209,181809
26/2/21,Lithuania,196690,8.9,19997.59,14427,3225,182263
27/2/21,Lithuania,197343,8.94,19997.59,14019,3234,183324
28/2/21,Lithuania,199145,8.95,19997.59,14360,3244,184785
1/3/21,Lithuania,199398,9.23,19997.59,14550,3253,184848
2/3/21,Lithuania,199825,9.58,19997.59,14055,3263,185770
3/3/21,Lithuania,200351,10.03,19997.59,14142,3281,186209
4/3/21,Lithuania,200898,10.61,19997.59,14161,3294,186737
5/3/21,Lithuania,201335,11.13,19997.59,14173,3303,187162
6/3/21,Lithuania,201799,11.15,19997.59,13696,3321,188103
7/3/21,Lithuania,202214,11.15,19997.59,14023,3328,188191
8/3/21,Lithuania,202430,11.49,19997.59,14185,3336,188245
9/3/21,Lithuania,202900,11.93,19997.59,13830,3341,189070
10/3/21,Lithuania,203386,12.51,19997.59,13907,3351,189479
11/3/21,Lithuania,203992,12.56,19997.59,13861,3363,190131
12/3/21,Lithuania,204356,13.23,19997.59,14122,3373,190234
13/3/21,Lithuania,204954,13.29,19997.59,13757,3389,191197
14/3/21,Lithuania,205385,13.29,19997.59,14108,3396,191277
15/3/21,Lithuania,205644,13.59,19997.59,14320,3410,191324
16/3/21,Lithuania,206290,13.97,19997.59,14172,3416,192118
17/3/21,Lithuania,206889,14.36,19997.59,14405,3427,192484
18/3/21,Lithuania,207469,14.68,19997.59,14547,3442,192922
19/3/21,Lithuania,208048,15.02,19997.59,14735,3452,193313
20/3/21,Lithuania,208650,15.05,19997.59,14460,3464,194190
21/3/21,Lithuania,209011,15.05,19997.59,14719,3476,194292
22/3/21,Lithuania,209340,15.36,19997.59,14995,3486,194345
23/3/21,Lithuania,210202,15.84,19997.59,15087,3501,195115
24/3/21,Lithuania,211011,16.5,19997.59,15460,3510,195551
25/3/21,Lithuania,211804,17.13,19997.59,15737,3521,196067
26/3/21,Lithuania,212676,17.75,19997.59,16172,3529,196504
27/3/21,Lithuania,213447,17.86,19997.59,15918,3539,197529
28/3/21,Lithuania,213941,17.87,19997.59,16323,3551,197618
29/3/21,Lithuania,214365,18.16,19997.59,16686,3560,197679
30/3/21,Lithuania,215216,18.65,19997.59,16628,3566,198588
31/3/21,Lithuania,216119,19.42,19997.59,17096,3574,199023
1/4/21,Lithuania,217005,20.1,19997.59,17238,3583,199767
2/4/21,Lithuania,217865,20.84,19997.59,17599,3594,200266
3/4/21,Lithuania,218878,21.17,19997.59,17280,3602,201598
4/4/21,Lithuania,219607,21.26,19997.59,17927,3610,201680
5/4/21,Lithuania,220212,21.39,19997.59,18485,3615,201727
6/4/21,Lithuania,220900,21.94,19997.59,19055,3623,201845
7/4/21,Lithuania,222020,22.42,19997.59,18978,3635,203042
8/4/21,Lithuania,223127,23.42,19997.59,19324,3647,203803
9/4/21,Lithuania,224309,24.67,19997.59,19969,3660,204340
10/4/21,Lithuania,225308,25.25,19997.59,19540,3671,205768
11/4/21,Lithuania,226173,25.31,19997.59,20276,3687,205897
12/4/21,Lithuania,226783,25.64,19997.59,20818,3697,205965
13/4/21,Lithuania,227889,26.34,19997.59,20498,3713,207391
14/4/21,Lithuania,229260,27.34,19997.59,21137,3718,208123
15/4/21,Lithuania,230462,28.21,19997.59,21572,3730,208890
16/4/21,Lithuania,231601,28.97,19997.59,22063,3739,209538
17/4/21,Lithuania,232829,29.06,19997.59,21523,3751,211306
18/4/21,Lithuania,233631,29.06,19997.59,22220,3760,211411
19/4/21,Lithuania,234232,29.28,19997.59,22729,3770,211503
20/4/21,Lithuania,235383,29.85,19997.59,22265,3785,213118
21/4/21,Lithuania,236533,30.84,19997.59,22563,3802,213970
22/4/21,Lithuania,237950,31.82,19997.59,22919,3818,215031
23/4/21,Lithuania,239263,32.74,19997.59,23443,3833,215820
24/4/21,Lithuania,240522,32.91,19997.59,22743,3841,217779
25/4/21,Lithuania,241297,32.92,19997.59,23386,3848,217911
26/4/21,Lithuania,241872,33.15,19997.59,23861,3857,218011
27/4/21,Lithuania,242926,33.63,19997.59,23248,3877,219678
28/4/21,Lithuania,244555,34.2,19997.59,23990,3900,220565
29/4/21,Lithuania,245896,35.42,19997.59,24320,3916,221576
30/4/21,Lithuania,247269,36.82,19997.59,24833,3923,222436
1/5/21,Lithuania,248655,37.41,19997.59,24006,3937,224649
2/5/21,Lithuania,249680,37.44,19997.59,24847,3950,224833
3/5/21,Lithuania,250337,37.94,19997.59,25395,3956,224942
4/5/21,Lithuania,251450,38.99,19997.59,24855,3976,226595
5/5/21,Lithuania,252699,40.27,19997.59,25173,3993,227526
6/5/21,Lithuania,254091,41.58,19997.59,25395,4000,228696
7/5/21,Lithuania,255384,42.81,19997.59,25717,4019,229667
8/5/21,Lithuania,256906,43.4,19997.59,25065,4024,231841
9/5/21,Lithuania,257827,43.66,19997.59,25751,4034,232076
10/5/21,Lithuania,258623,44.4,19997.59,26404,4045,232219
11/5/21,Lithuania,259862,45.37,19997.59,25639,4053,234223
12/5/21,Lithuania,261128,46.55,19997.59,25863,4059,235265
13/5/21,Lithuania,262335,47.66,19997.59,25893,4071,236442
14/5/21,Lithuania,263475,48.82,19997.59,26044,4084,237431
15/5/21,Lithuania,264724,49.05,19997.59,25022,4088,239702
16/5/21,Lithuania,265536,49.07,19997.59,25621,4103,239915
17/5/21,Lithuania,266063,49.64,19997.59,25984,4112,240079
18/5/21,Lithuania,266795,50.53,19997.59,24692,4126,242103
19/5/21,Lithuania,267769,51.75,19997.59,24643,4136,243126
20/5/21,Lithuania,268684,52.92,19997.59,24332,4155,244352
21/5/21,Lithuania,269363,53.85,19997.59,24728,4161,244635
22/5/21,Lithuania,270376,54.18,19997.59,22951,4173,247425
23/5/21,Lithuania,270849,54.24,19997.59,23187,4185,247662
24/5/21,Lithuania,271130,54.74,19997.59,23311,4195,247819
25/5/21,Lithuania,271682,55.67,19997.59,22042,4209,249640
26/5/21,Lithuania,272231,56.73,19997.59,21570,4220,250661
27/5/21,Lithuania,272826,57.82,19997.59,21117,4229,251709
28/5/21,Lithuania,273346,58.98,19997.59,20764,4235,252582
29/5/21,Lithuania,273866,59.3,19997.59,19544,4245,254322
30/5/21,Lithuania,274199,59.32,19997.59,19617,4257,254582
31/5/21,Lithuania,274383,59.99,19997.59,19636,4266,254747
1/6/21,Lithuania,274776,61.19,19997.59,18600,4276,256176
2/6/21,Lithuania,275198,62.68,19997.59,18311,4283,256887
3/6/21,Lithuania,275545,64.04,19997.59,17870,4289,257675
4/6/21,Lithuania,275915,65.57,19997.59,17574,4297,258341
5/6/21,Lithuania,276256,66.17,19997.59,16665,4302,259591
6/6/21,Lithuania,276453,66.38,19997.59,16660,4307,259793
7/6/21,Lithuania,276543,67.18,19997.59,16634,4309,259909
8/6/21,Lithuania,276759,68.16,19997.59,15886,4317,260873
9/6/21,Lithuania,277002,69.19,19997.59,15611,4320,261391
10/6/21,Lithuania,277222,70.13,19997.59,15306,4327,261916
11/6/21,Lithuania,277379,70.99,19997.59,15239,4330,262140
12/6/21,Lithuania,277623,71.21,19997.59,14407,4335,263216
13/6/21,Lithuania,277746,71.36,19997.59,14384,4339,263362
14/6/21,Lithuania,277812,72.1,19997.59,14370,4342,263442
15/6/21,Lithuania,277942,73,19997.59,13905,4348,264037
16/6/21,Lithuania,278072,74.07,19997.59,13710,4352,264362
17/6/21,Lithuania,278177,75.15,19997.59,13458,4357,264719
18/6/21,Lithuania,278254,76.1,19997.59,13231,4360,265023
19/6/21,Lithuania,278328,76.35,19997.59,12821,4364,265507
20/6/21,Lithuania,278379,76.39,19997.59,12792,4366,265587
21/6/21,Lithuania,278407,76.98,19997.59,12774,4367,265633
22/6/21,Lithuania,278466,77.93,19997.59,12500,4371,265966
23/6/21,Lithuania,278526,78.95,19997.59,11684,4371,266842
24/6/21,Lithuania,278590,79.33,19997.59,11535,4375,267055
25/6/21,Lithuania,278608,80.41,19997.59,11453,4378,267155
26/6/21,Lithuania,278655,80.72,19997.59,11320,4379,267335
27/6/21,Lithuania,278674,80.95,19997.59,11325,4380,267349
28/6/21,Lithuania,278689,81.7,19997.59,11285,4381,267404
29/6/21,Lithuania,278726,82.62,19997.59,11161,4381,267565
30/6/21,Lithuania,278769,83.49,19997.59,11133,4383,267636
1/2/21,Slovenia,166836,3.99,25179.67,20833,3522,146003
2/2/21,Slovenia,168486,4.05,25179.67,20799,3541,147687
3/2/21,Slovenia,170101,4.28,25179.67,20716,3564,149385
4/2/21,Slovenia,171340,4.64,25179.67,20480,3580,150860
5/2/21,Slovenia,172299,4.91,25179.67,20009,3595,152290
6/2/21,Slovenia,173201,4.94,25179.67,19410,3612,153791
7/2/21,Slovenia,173702,4.94,25179.67,19381,3623,154321
8/2/21,Slovenia,174000,4.96,25179.67,19393,3635,154607
9/2/21,Slovenia,174364,4.97,25179.67,18098,3654,156266
10/2/21,Slovenia,175795,5.12,25179.67,17667,3667,158128
11/2/21,Slovenia,177140,5.55,25179.67,17483,3677,159657
12/2/21,Slovenia,178133,5.97,25179.67,17180,3692,160953
13/2/21,Slovenia,179148,6.01,25179.67,16900,3705,162248
14/2/21,Slovenia,179477,6.01,25179.67,16653,3717,162824
15/2/21,Slovenia,179780,6.02,25179.67,16618,3728,163162
16/2/21,Slovenia,180520,6.07,25179.67,15844,3733,164676
17/2/21,Slovenia,181606,6.34,25179.67,15386,3745,166220
18/2/21,Slovenia,182484,6.78,25179.67,15007,3755,167477
19/2/21,Slovenia,183396,7.1,25179.67,14964,3762,168432
20/2/21,Slovenia,184352,7.23,25179.67,14946,3769,169406
21/2/21,Slovenia,184767,7.23,25179.67,14871,3776,169896
22/2/21,Slovenia,185014,7.25,25179.67,14816,3784,170198
23/2/21,Slovenia,185916,7.32,25179.67,15389,3792,170527
24/2/21,Slovenia,187005,7.66,25179.67,15100,3802,171905
25/2/21,Slovenia,187762,8.19,25179.67,15857,3809,171905
26/2/21,Slovenia,188676,8.56,25179.67,16771,3823,171905
27/2/21,Slovenia,189627,8.61,25179.67,14417,3836,175210
28/2/21,Slovenia,190081,8.61,25179.67,14871,3836,175210
1/3/21,Slovenia,190324,8.66,25179.67,15114,3854,175210
2/3/21,Slovenia,191056,8.77,25179.67,15846,3863,175210
3/3/21,Slovenia,192266,9.13,25179.67,14625,3874,177641
4/3/21,Slovenia,193285,9.68,25179.67,14775,3878,178510
5/3/21,Slovenia,194165,10.18,25179.67,14751,3882,179414
6/3/21,Slovenia,195086,10.27,25179.67,14720,3888,180366
7/3/21,Slovenia,195468,10.27,25179.67,15102,3891,180366
8/3/21,Slovenia,195678,10.36,25179.67,14655,3897,181023
9/3/21,Slovenia,196421,10.56,25179.67,14506,3904,181915
10/3/21,Slovenia,197374,11.03,25179.67,14372,3908,183002
11/3/21,Slovenia,198234,11.71,25179.67,14386,3918,183848
12/3/21,Slovenia,199004,12.37,25179.67,14251,3926,184753
13/3/21,Slovenia,199854,12.79,25179.67,14156,3929,185698
14/3/21,Slovenia,200374,12.79,25179.67,14227,3934,186147
15/3/21,Slovenia,200579,12.87,25179.67,14193,3938,186386
16/3/21,Slovenia,201497,12.92,25179.67,14385,3941,187112
17/3/21,Slovenia,202573,13.21,25179.67,14258,3948,188315
18/3/21,Slovenia,203544,13.7,25179.67,14211,3951,189333
19/3/21,Slovenia,204482,14.06,25179.67,14276,3961,190206
20/3/21,Slovenia,205509,14.27,25179.67,14387,3967,191122
21/3/21,Slovenia,206026,14.27,25179.67,14526,3972,191500
22/3/21,Slovenia,206317,14.32,25179.67,14611,3976,191706
23/3/21,Slovenia,207298,14.53,25179.67,14859,3985,192439
24/3/21,Slovenia,208588,15.01,25179.67,15205,3994,193383
25/3/21,Slovenia,209753,15.71,25179.67,15515,3998,194238
26/3/21,Slovenia,210785,16.48,25179.67,15785,4008,195000
27/3/21,Slovenia,212040,16.84,25179.67,16195,4011,195845
28/3/21,Slovenia,212678,16.9,25179.67,16359,4018,196319
29/3/21,Slovenia,212966,16.95,25179.67,16448,4024,196518
30/3/21,Slovenia,214045,17.34,25179.67,16625,4040,197420
31/3/21,Slovenia,215602,18.05,25179.67,17078,4047,198524
1/4/21,Slovenia,216939,18.99,25179.67,17449,4054,199490
2/4/21,Slovenia,218114,19.58,25179.67,17692,4063,200422
3/4/21,Slovenia,219420,19.73,25179.67,17974,4068,201446
4/4/21,Slovenia,220141,19.8,25179.67,18185,4075,201956
5/4/21,Slovenia,220425,19.8,25179.67,18186,4082,202239
6/4/21,Slovenia,220698,19.94,25179.67,17484,4089,203214
7/4/21,Slovenia,221890,20.24,25179.67,17393,4092,204497
8/4/21,Slovenia,223416,20.98,25179.67,17761,4097,205655
9/4/21,Slovenia,224699,21.95,25179.67,18011,4100,206688
10/4/21,Slovenia,225950,22.4,25179.67,18023,4112,207927
11/4/21,Slovenia,226499,22.48,25179.67,17938,4119,208561
12/4/21,Slovenia,226786,22.57,25179.67,17944,4126,208842
13/4/21,Slovenia,227836,22.75,25179.67,17916,4130,209920
14/4/21,Slovenia,229076,23.31,25179.67,17591,4135,211485
15/4/21,Slovenia,229967,24.26,25179.67,17152,4142,212815
16/4/21,Slovenia,230826,24.94,25179.67,16846,4147,213980
17/4/21,Slovenia,231593,25.23,25179.67,16321,4153,215272
18/4/21,Slovenia,232071,25.3,25179.67,16085,4159,215986
19/4/21,Slovenia,232311,25.43,25179.67,16050,4167,216261
20/4/21,Slovenia,233031,25.75,25179.67,16503,4172,216528
21/4/21,Slovenia,234067,26.56,25179.67,16352,4176,217715
22/4/21,Slovenia,234811,27.53,25179.67,15579,4187,219232
23/4/21,Slovenia,235711,28.38,25179.67,15206,4195,220505
24/4/21,Slovenia,236613,28.53,25179.67,14799,4203,221814
25/4/21,Slovenia,237028,28.56,25179.67,14670,4208,222358
26/4/21,Slovenia,237219,28.58,25179.67,14576,4214,222643
27/4/21,Slovenia,238023,28.6,25179.67,14337,4221,223686
28/4/21,Slovenia,238421,28.99,25179.67,13514,4236,224907
29/4/21,Slovenia,239339,29.92,25179.67,13547,4243,225792
30/4/21,Slovenia,240292,30.94,25179.67,13645,4250,226647
1/5/21,Slovenia,241309,31.29,25179.67,13898,4258,227411
2/5/21,Slovenia,241672,31.46,25179.67,13789,4263,227883
3/5/21,Slovenia,241883,31.84,25179.67,13773,4269,228110
4/5/21,Slovenia,242777,32.33,25179.67,13948,4273,228829
5/5/21,Slovenia,243719,33.2,25179.67,13858,4279,229861
6/5/21,Slovenia,244556,34.55,25179.67,13954,4282,230602
7/5/21,Slovenia,245159,35.62,25179.67,13600,4285,231559
8/5/21,Slovenia,245793,36.14,25179.67,13404,4286,232389
9/5/21,Slovenia,246082,36.23,25179.67,13284,4293,232798
10/5/21,Slovenia,246231,36.41,25179.67,13248,4299,232983
11/5/21,Slovenia,246725,36.91,25179.67,12937,4302,233788
12/5/21,Slovenia,247449,37.99,25179.67,13260,4304,234189
13/5/21,Slovenia,248046,39.4,25179.67,12940,4308,235106
14/5/21,Slovenia,248520,40.66,25179.67,12471,4314,236049
15/5/21,Slovenia,249014,41.2,25179.67,11953,4320,237061
16/5/21,Slovenia,249310,41.35,25179.67,11886,4324,237424
17/5/21,Slovenia,249424,41.77,25179.67,11794,4327,237630
18/5/21,Slovenia,249921,42.45,25179.67,11404,4333,238517
19/5/21,Slovenia,250453,43.6,25179.67,11011,4338,239442
20/5/21,Slovenia,250811,45.08,25179.67,10600,4345,240211
21/5/21,Slovenia,251148,46.43,25179.67,10332,4348,240816
22/5/21,Slovenia,251531,46.96,25179.67,10083,4349,241448
23/5/21,Slovenia,251690,47.11,25179.67,9955,4353,241735
24/5/21,Slovenia,251773,47.43,25179.67,9894,4355,241879
25/5/21,Slovenia,252098,47.95,25179.67,9732,4358,242366
26/5/21,Slovenia,252486,49.03,25179.67,9396,4363,243090
27/5/21,Slovenia,252848,50.47,25179.67,9163,4366,243685
28/5/21,Slovenia,253140,51.56,25179.67,8987,4370,244153
29/5/21,Slovenia,253493,52.08,25179.67,8847,4372,244646
30/5/21,Slovenia,253631,52.08,25179.67,8694,4374,244937
31/5/21,Slovenia,253722,52.42,25179.67,8673,4375,245049
1/6/21,Slovenia,254045,53.23,25179.67,8500,4376,245545
2/6/21,Slovenia,254419,54.7,25179.67,8340,4380,246079
3/6/21,Slovenia,254692,56.54,25179.67,8259,4383,246433
4/6/21,Slovenia,254973,58.09,25179.67,8209,4385,246764
5/6/21,Slovenia,255218,58.75,25179.67,8075,4387,247143
6/6/21,Slovenia,255375,59.07,25179.67,8076,4388,247299
7/6/21,Slovenia,255432,59.44,25179.67,8051,4390,247381
8/6/21,Slovenia,255652,60.18,25179.67,7949,4391,247703
9/6/21,Slovenia,255907,61.33,25179.67,7814,4392,248093
10/6/21,Slovenia,256103,62.97,25179.67,7644,4393,248459
11/6/21,Slovenia,256224,64.18,25179.67,7481,4398,248743
12/6/21,Slovenia,256352,64.73,25179.67,7254,4401,249098
13/6/21,Slovenia,256443,64.89,25179.67,7211,4404,249232
14/6/21,Slovenia,256467,65.22,25179.67,7146,4406,249321
15/6/21,Slovenia,256581,65.74,25179.67,6939,4408,249642
16/6/21,Slovenia,256701,66.6,25179.67,6685,4409,250016
17/6/21,Slovenia,256784,67.66,25179.67,6496,4409,250288
18/6/21,Slovenia,256871,68.38,25179.67,6305,4411,250566
19/6/21,Slovenia,256956,68.51,25179.67,6143,4412,250813
20/6/21,Slovenia,256982,68.58,25179.67,6012,4412,250970
21/6/21,Slovenia,257001,68.87,25179.67,5977,4415,251024
22/6/21,Slovenia,257066,69.39,25179.67,5823,4416,251243
23/6/21,Slovenia,257116,70.4,25179.67,5620,4417,251496
24/6/21,Slovenia,257164,71.69,25179.67,5472,4417,251692
25/6/21,Slovenia,257210,71.69,25179.67,5395,4417,251815
26/6/21,Slovenia,257221,71.89,25179.67,5282,4419,251939
27/6/21,Slovenia,257240,71.9,25179.67,5210,4419,252030
28/6/21,Slovenia,257252,72.21,25179.67,5198,4419,252054
29/6/21,Slovenia,257287,72.8,25179.67,5120,4419,252167
30/6/21,Slovenia,257335,73.53,25179.67,5050,4419,252285
1/2/21,Romania,730056,3.77,12896.09,54289,18402,675767
2/2/21,Romania,732732,3.91,12896.09,54259,18513,678473
3/2/21,Romania,735484,4.04,12896.09,54213,18600,681271
4/2/21,Romania,738152,4.16,12896.09,54057,18675,684095
5/2/21,Romania,740732,4.3,12896.09,54040,18748,686692
6/2/21,Romania,743343,4.4,12896.09,53869,18809,689474
7/2/21,Romania,745318,4.48,12896.09,53941,18881,691377
8/2/21,Romania,746637,4.66,12896.09,53956,18961,692681
9/2/21,Romania,749434,4.86,12896.09,54036,19056,695398
10/2/21,Romania,752482,5.08,12896.09,53948,19135,698534
11/2/21,Romania,755126,5.28,12896.09,53843,19200,701283
12/2/21,Romania,757676,5.48,12896.09,53710,19277,703966
13/2/21,Romania,760091,5.67,12896.09,53697,19325,706394
14/2/21,Romania,761963,5.82,12896.09,53812,19366,708151
15/2/21,Romania,763294,6.02,12896.09,53774,19445,709520
16/2/21,Romania,765970,6.26,12896.09,53993,19526,711977
17/2/21,Romania,768785,6.48,12896.09,54076,19588,714709
18/2/21,Romania,771843,6.69,12896.09,54664,19659,717179
19/2/21,Romania,774555,6.89,12896.09,54862,19738,719693
20/2/21,Romania,777276,7.06,12896.09,54792,19795,722484
21/2/21,Romania,779695,7.21,12896.09,55362,19847,724333
22/2/21,Romania,781329,7.37,12896.09,55803,19894,725526
23/2/21,Romania,784711,7.52,12896.09,56459,20013,728252
24/2/21,Romania,788048,7.67,12896.09,56999,20086,731049
25/2/21,Romania,791971,7.77,12896.09,58355,20167,733616
26/2/21,Romania,795732,7.87,12896.09,59712,20233,736020
27/2/21,Romania,799164,7.96,12896.09,60595,20287,738569
28/2/21,Romania,801994,8.01,12896.09,61642,20350,740352
1/3/21,Romania,804090,8.18,12896.09,62619,20403,741471
2/3/21,Romania,808040,8.38,12896.09,64000,20509,744040
3/3/21,Romania,812318,8.58,12896.09,65539,20586,746779
4/3/21,Romania,816589,8.81,12896.09,66916,20684,749673
5/3/21,Romania,820931,9.06,12896.09,68697,20785,752234
6/3/21,Romania,824995,9.31,12896.09,70660,20854,754335
7/3/21,Romania,828283,9.55,12896.09,73948,20900,754335
8/3/21,Romania,830563,9.78,12896.09,68932,20963,761631
9/3/21,Romania,835552,10.03,12896.09,68333,21056,767219
10/3/21,Romania,840116,10.3,12896.09,69262,21156,770854
11/3/21,Romania,845352,10.56,12896.09,71075,21252,774277
12/3/21,Romania,850362,10.82,12896.09,72647,21360,777715
13/3/21,Romania,855326,11.07,12896.09,74172,21439,781154
14/3/21,Romania,859709,11.3,12896.09,76067,21483,783642
15/3/21,Romania,862681,11.55,12896.09,75289,21565,787392
16/3/21,Romania,868799,11.87,12896.09,81407,21698,787392
17/3/21,Romania,874985,12.15,12896.09,84172,21787,790813
18/3/21,Romania,881159,12.42,12896.09,86209,21877,794950
19/3/21,Romania,886752,12.68,12896.09,87767,22020,798985
20/3/21,Romania,892848,12.95,12896.09,89622,22132,803226
21/3/21,Romania,897115,13.18,12896.09,90915,22208,806200
22/3/21,Romania,900858,13.43,12896.09,92104,22268,808754
23/3/21,Romania,907007,13.73,12896.09,92825,22442,814182
24/3/21,Romania,913143,14.04,12896.09,93344,22579,819799
25/3/21,Romania,919794,14.35,12896.09,94586,22719,825208
26/3/21,Romania,926310,14.64,12896.09,96040,22835,830270
27/3/21,Romania,932179,14.94,12896.09,98017,22997,834162
28/3/21,Romania,936618,15.23,12896.09,99558,23114,837060
29/3/21,Romania,940443,15.5,12896.09,100316,23234,840127
30/3/21,Romania,946647,15.84,12896.09,101290,23409,845357
31/3/21,Romania,952803,16.15,12896.09,102131,23538,850672
1/4/21,Romania,958918,16.45,12896.09,102513,23674,856405
2/4/21,Romania,964726,16.75,12896.09,102589,23819,862137
3/4/21,Romania,970224,17.04,12896.09,102561,23973,867663
4/4/21,Romania,974375,17.29,12896.09,102425,24070,871950
5/4/21,Romania,977986,17.56,12896.09,102499,24190,875487
6/4/21,Romania,983217,17.85,12896.09,102788,24386,880429
7/4/21,Romania,988624,18.14,12896.09,102914,24561,885710
8/4/21,Romania,993613,18.43,12896.09,103085,24733,890528
9/4/21,Romania,998555,18.72,12896.09,101982,24867,896573
10/4/21,Romania,1002865,19.04,12896.09,100626,25006,902239
11/4/21,Romania,1006167,19.34,12896.09,99508,25135,906659
12/4/21,Romania,1008490,19.67,12896.09,98192,25248,910298
13/4/21,Romania,1012373,20.07,12896.09,96909,25441,915464
14/4/21,Romania,1016449,20.49,12896.09,95796,25605,920653
15/4/21,Romania,1020301,20.91,12896.09,94906,25800,925395
16/4/21,Romania,1023565,21.32,12896.09,92623,25937,930942
17/4/21,Romania,1027039,21.75,12896.09,90524,26072,936515
18/4/21,Romania,1029304,22.12,12896.09,88512,26232,940792
19/4/21,Romania,1031072,22.52,12896.09,86298,26381,944774
20/4/21,Romania,1034003,22.98,12896.09,83761,26618,950242
21/4/21,Romania,1037009,23.46,12896.09,82141,26793,954868
22/4/21,Romania,1039998,23.92,12896.09,80872,26943,959126
23/4/21,Romania,1042521,24.39,12896.09,78681,27113,963840
24/4/21,Romania,1044722,24.86,12896.09,75976,27267,968746
25/4/21,Romania,1046264,25.26,12896.09,73788,27394,972476
26/4/21,Romania,1047520,25.69,12896.09,71817,27511,975703
27/4/21,Romania,1049539,26.13,12896.09,70094,27683,979445
28/4/21,Romania,1051779,26.57,12896.09,68739,27833,983040
29/4/21,Romania,1053629,26.99,12896.09,67802,27971,985827
30/4/21,Romania,1055265,27.4,12896.09,65872,28109,989393
1/5/21,Romania,1056572,27.71,12896.09,63967,28194,992605
2/5/21,Romania,1057655,27.93,12896.09,62149,28282,995506
3/5/21,Romania,1058337,28.27,12896.09,60588,28380,997749
4/5/21,Romania,1059331,28.72,12896.09,58880,28474,1000451
5/5/21,Romania,1060895,29.22,12896.09,57910,28616,1002985
6/5/21,Romania,1062527,29.74,12896.09,56904,28710,1005623
7/5/21,Romania,1063949,30.22,12896.09,54712,28799,1009237
8/5/21,Romania,1065254,30.8,12896.09,53560,28903,1011694
9/5/21,Romania,1066111,31.35,12896.09,52445,28966,1013666
10/5/21,Romania,1066731,31.87,12896.09,51639,29034,1015092
11/5/21,Romania,1067887,32.42,12896.09,50840,29135,1017047
12/5/21,Romania,1068817,32.97,12896.09,50175,29233,1018642
13/5/21,Romania,1069770,33.51,12896.09,49576,29308,1020194
14/5/21,Romania,1070605,34.08,12896.09,48576,29413,1022029
15/5/21,Romania,1071334,34.71,12896.09,47512,29485,1023822
16/5/21,Romania,1071899,35.24,12896.09,46754,29523,1025145
17/5/21,Romania,1072291,35.73,12896.09,45992,29571,1026299
18/5/21,Romania,1072972,36.24,12896.09,45560,29662,1027412
19/5/21,Romania,1073679,36.73,12896.09,45125,29716,1028554
20/5/21,Romania,1074297,37.19,12896.09,44922,29777,1029375
21/5/21,Romania,1074781,37.64,12896.09,44644,29826,1030137
22/5/21,Romania,1075236,38.03,12896.09,43631,29885,1031605
23/5/21,Romania,1075543,38.31,12896.09,42655,29941,1032888
24/5/21,Romania,1075773,38.61,12896.09,41789,29977,1033984
25/5/21,Romania,1076154,38.97,12896.09,41039,30040,1035115
26/5/21,Romania,1076533,39.35,12896.09,40631,30092,1035902
27/5/21,Romania,1076840,39.7,12896.09,40194,30131,1036646
28/5/21,Romania,1077161,40.06,12896.09,39432,30174,1037729
29/5/21,Romania,1077426,40.47,12896.09,38887,30247,1038539
30/5/21,Romania,1077584,40.83,12896.09,38411,30276,1039173
31/5/21,Romania,1077737,41.16,12896.09,37916,30312,1039821
1/6/21,Romania,1077978,41.44,12896.09,37451,30353,1040527
2/6/21,Romania,1078142,41.73,12896.09,37273,30415,1040869
3/6/21,Romania,1078338,42.05,12896.09,37082,30499,1041256
4/6/21,Romania,1078563,42.4,12896.09,36639,30612,1041924
5/6/21,Romania,1078742,42.77,12896.09,36191,30725,1042551
6/6/21,Romania,1078863,43.07,12896.09,35965,30815,1042898
7/6/21,Romania,1078952,43.33,12896.09,35781,30878,1043171
8/6/21,Romania,1079154,43.59,12896.09,35783,31155,1043371
9/6/21,Romania,1079294,43.83,12896.09,35812,31383,1043482
10/6/21,Romania,1079427,44.05,12896.09,35823,31531,1043604
11/6/21,Romania,1079530,44.26,12896.09,35727,31681,1043803
12/6/21,Romania,1079657,44.47,12896.09,35657,31804,1044000
13/6/21,Romania,1079726,44.63,12896.09,35489,31834,1044237
14/6/21,Romania,1079776,44.79,12896.09,35372,31861,1044404
15/6/21,Romania,1079879,44.96,12896.09,35316,31957,1044563
16/6/21,Romania,1079983,45.13,12896.09,35296,32028,1044687
17/6/21,Romania,1080070,45.28,12896.09,35297,32115,1044773
18/6/21,Romania,1080140,45.44,12896.09,35221,32212,1044919
19/6/21,Romania,1080203,45.57,12896.09,35259,32308,1044944
20/6/21,Romania,1080256,45.68,12896.09,35134,32326,1045122
21/6/21,Romania,1080282,45.78,12896.09,35075,32391,1045207
22/6/21,Romania,1080323,45.9,12896.09,35020,32465,1045303
23/6/21,Romania,1080389,46.04,12896.09,35086,32626,1045303
24/6/21,Romania,1080457,46.17,12896.09,35154,32771,1045303
25/6/21,Romania,1080522,46.26,12896.09,35171,32911,1045351
26/6/21,Romania,1080584,26.35,12896.09,35233,33177,1045351
27/6/21,Romania,1080630,46.43,12896.09,35279,33253,1045351
28/6/21,Romania,1080667,46.62,12896.09,35316,33311,1045351
29/6/21,Romania,1080740,46.72,12896.09,35389,33605,1045351
30/6/21,Romania,1080792,46.83,12896.09,35441,33786,1045351
1/2/21,Estonia,44575,3.03,23312.28,10627,422,33948
2/2/21,Estonia,44978,3.24,23312.28,10051,424,34927
3/2/21,Estonia,45663,3.48,23312.28,9986,433,35677
4/2/21,Estonia,46334,3.75,23312.28,10005,443,36329
5/2/21,Estonia,46925,3.98,23312.28,10044,447,36881
6/2/21,Estonia,47512,4.02,23312.28,9864,456,37648
7/2/21,Estonia,47928,4.03,23312.28,10143,461,37785
8/2/21,Estonia,48267,4.15,23312.28,10359,466,37908
9/2/21,Estonia,48809,4.39,23312.28,10079,474,38730
10/2/21,Estonia,49605,4.65,23312.28,10219,477,39386
11/2/21,Estonia,50280,4.96,23312.28,10352,480,39928
12/2/21,Estonia,50993,5.14,23312.28,10517,486,40476
13/2/21,Estonia,51749,5.16,23312.28,10550,491,41199
14/2/21,Estonia,52416,5.16,23312.28,11089,495,41327
15/2/21,Estonia,52827,5.23,23312.28,11366,501,41461
16/2/21,Estonia,53444,5.41,23312.28,11041,508,42403
17/2/21,Estonia,54300,5.73,23312.28,11246,510,43054
18/2/21,Estonia,55295,6.21,23312.28,11632,514,43663
19/2/21,Estonia,56246,6.57,23312.28,11998,518,44248
20/2/21,Estonia,57033,6.63,23312.28,11953,528,45080
21/2/21,Estonia,57616,6.69,23312.28,12383,535,45233
22/2/21,Estonia,58445,6.92,23312.28,13093,540,45352
23/2/21,Estonia,59407,7.27,23312.28,13072,553,46335
24/2/21,Estonia,60475,7.31,23312.28,13336,557,47139
25/2/21,Estonia,61627,7.8,23312.28,14167,567,47460
26/2/21,Estonia,62830,8.37,23312.28,14339,575,48491
27/2/21,Estonia,64399,8.48,23312.28,14690,584,49709
28/2/21,Estonia,65600,8.5,23312.28,15692,589,49908
1/3/21,Estonia,66628,8.77,23312.28,16525,598,50103
2/3/21,Estonia,67739,9.16,23312.28,17388,605,50351
3/3/21,Estonia,69193,9.56,23312.28,18553,615,50640
4/3/21,Estonia,70610,10.14,23312.28,17250,623,53360
5/3/21,Estonia,72144,10.67,23312.28,18018,637,54126
6/3/21,Estonia,73684,10.96,23312.28,18523,644,55161
7/3/21,Estonia,75003,11.03,23312.28,19607,653,55396
8/3/21,Estonia,76183,11.31,23312.28,20542,667,55641
9/3/21,Estonia,77491,11.69,23312.28,20285,669,57206
10/3/21,Estonia,78973,12.18,23312.28,21510,677,57463
11/3/21,Estonia,80929,13.02,23312.28,23213,686,57716
12/3/21,Estonia,82286,13.6,23312.28,24243,695,58043
13/3/21,Estonia,83872,14.01,23312.28,24487,710,59385
14/3/21,Estonia,84807,14.41,23312.28,25063,719,59744
15/3/21,Estonia,86086,14.68,23312.28,26079,728,60007
16/3/21,Estonia,87548,15.03,23312.28,27172,739,60376
17/3/21,Estonia,89331,15.44,23312.28,28588,745,60743
18/3/21,Estonia,91031,16,23312.28,26341,758,64690
19/3/21,Estonia,92780,16.65,23312.28,27741,769,65039
20/3/21,Estonia,94028,16.82,23312.28,26530,780,67498
21/3/21,Estonia,95401,16.92,23312.28,27587,787,67814
22/3/21,Estonia,96394,17.11,23312.28,28145,797,68249
23/3/21,Estonia,97456,17.33,23312.28,27110,809,70346
24/3/21,Estonia,99008,17.75,23312.28,28095,823,70913
25/3/21,Estonia,100437,18.51,23312.28,29061,836,71376
26/3/21,Estonia,101587,19.01,23312.28,29562,847,72025
27/3/21,Estonia,102738,19.2,23312.28,26107,860,76631
28/3/21,Estonia,103630,19.24,23312.28,26360,868,77270
29/3/21,Estonia,104214,19.41,23312.28,26347,879,77867
30/3/21,Estonia,105416,19.68,23312.28,25324,896,80092
31/3/21,Estonia,106424,20.13,23312.28,24565,902,81859
1/4/21,Estonia,107253,21.03,23312.28,23836,908,83417
2/4/21,Estonia,108418,21.33,23312.28,23365,922,85053
3/4/21,Estonia,108937,21.96,23312.28,23037,931,85900
4/4/21,Estonia,109399,22.27,23312.28,22875,941,86524
5/4/21,Estonia,109781,22.54,23312.28,22689,950,87092
6/4/21,Estonia,110680,22.81,23312.28,21575,964,89105
7/4/21,Estonia,111664,23.26,23312.28,21113,976,90551
8/4/21,Estonia,112421,24.24,23312.28,20632,990,91789
9/4/21,Estonia,113098,25.04,23312.28,20236,1006,92862
10/4/21,Estonia,113736,25.16,23312.28,19530,1020,94206
11/4/21,Estonia,114174,25.19,23312.28,19367,1028,94807
12/4/21,Estonia,114443,25.33,23312.28,19197,1037,95246
13/4/21,Estonia,115080,25.55,23312.28,18236,1049,96844
14/4/21,Estonia,115629,26.09,23312.28,17740,1057,97889
15/4/21,Estonia,116200,27.04,23312.28,17104,1064,99096
16/4/21,Estonia,116678,27.91,23312.28,16502,1070,100176
17/4/21,Estonia,117011,28.06,23312.28,15540,1082,101471
18/4/21,Estonia,117554,28.17,23312.28,15675,1092,101879
19/4/21,Estonia,117782,28.37,23312.28,15556,1100,102226
20/4/21,Estonia,118317,28.68,23312.28,14731,1104,103586
21/4/21,Estonia,118789,29.07,23312.28,14136,1109,104653
22/4/21,Estonia,119218,29.94,23312.28,13747,1120,105471
23/4/21,Estonia,119610,30.62,23312.28,13355,1126,106255
24/4/21,Estonia,120000,30.85,23312.28,12702,1137,107298
25/4/21,Estonia,120215,31.03,23312.28,12917,1143,107298
26/4/21,Estonia,120378,31.27,23312.28,12472,1145,107906
27/4/21,Estonia,120836,31.79,23312.28,11868,1148,108968
28/4/21,Estonia,121232,32.63,23312.28,11372,1148,109860
29/4/21,Estonia,121657,33.75,23312.28,11058,1158,110599
30/4/21,Estonia,122019,34.64,23312.28,10745,1161,111274
1/5/21,Estonia,122450,34.87,23312.28,10443,1166,112007
2/5/21,Estonia,122685,35.05,23312.28,10418,1168,112267
3/5/21,Estonia,122943,35.49,23312.28,10463,1172,112480
4/5/21,Estonia,123344,36.14,23312.28,9948,1177,113396
5/5/21,Estonia,123781,37.13,23312.28,9748,1183,114033
6/5/21,Estonia,124147,38.46,23312.28,9529,1187,114618
7/5/21,Estonia,124529,39.5,23312.28,9469,1193,115060
8/5/21,Estonia,124901,39.91,23312.28,9202,1195,115699
9/5/21,Estonia,125126,40.15,23312.28,9218,1201,115908
10/5/21,Estonia,125337,40.48,23312.28,9313,1204,116024
11/5/21,Estonia,125696,40.95,23312.28,9048,1206,116648
12/5/21,Estonia,126064,41.71,23312.28,8956,1210,117108
13/5/21,Estonia,126364,42.69,23312.28,8782,1212,117582
14/5/21,Estonia,126642,43.35,23312.28,8634,1217,118008
15/5/21,Estonia,126922,43.61,23312.28,8369,1220,118553
16/5/21,Estonia,127053,43.68,23312.28,8375,1222,118678
17/5/21,Estonia,127206,44.2,23312.28,8434,1223,118772
18/5/21,Estonia,127500,44.8,23312.28,8072,1229,119428
19/5/21,Estonia,127757,45.48,23312.28,8149,1232,119608
20/5/21,Estonia,128084,46.59,23312.28,8285,1235,119799
21/5/21,Estonia,128309,47.67,23312.28,8169,1239,120140
22/5/21,Estonia,128489,48.03,23312.28,7864,1240,120625
23/5/21,Estonia,128592,48.31,23312.28,7706,1240,120886
24/5/21,Estonia,128669,48.73,23312.28,7555,1241,121114
25/5/21,Estonia,128829,49.26,23312.28,7249,1241,121580
26/5/21,Estonia,129014,50.12,23312.28,7095,1242,121919
27/5/21,Estonia,129158,51.34,23312.28,6881,1244,122277
28/5/21,Estonia,129297,52.28,23312.28,6755,1247,122542
29/5/21,Estonia,129424,52.67,23312.28,6506,1250,122918
30/5/21,Estonia,129486,53.01,23312.28,6489,1251,122997
31/5/21,Estonia,129544,53.3,23312.28,6471,1252,123073
1/6/21,Estonia,129674,53.94,23312.28,6437,1258,123237
2/6/21,Estonia,129804,54.77,23312.28,6215,1259,123589
3/6/21,Estonia,129909,55.83,23312.28,5876,1260,124033
4/6/21,Estonia,130005,56.7,23312.28,5844,1260,124161
5/6/21,Estonia,130068,57.1,23312.28,5492,1262,124576
6/6/21,Estonia,130119,57.49,23312.28,5460,1263,124659
7/6/21,Estonia,130156,57.96,23312.28,5440,1264,124716
8/6/21,Estonia,130242,58.69,23312.28,5251,1264,124991
9/6/21,Estonia,130310,59.7,23312.28,5119,1265,125191
10/6/21,Estonia,130364,60.83,23312.28,5008,1266,125356
11/6/21,Estonia,130418,61.72,23312.28,4890,1266,125528
12/6/21,Estonia,130473,62.24,23312.28,4758,1266,125715
13/6/21,Estonia,130510,62.58,23312.28,4757,1266,125753
14/6/21,Estonia,130538,63.17,23312.28,4740,1266,125798
15/6/21,Estonia,130599,63.97,23312.28,4670,1266,125929
16/6/21,Estonia,130658,64.96,23312.28,4470,1266,126188
17/6/21,Estonia,130695,66.03,23312.28,4315,1267,126380
18/6/21,Estonia,130751,67.09,23312.28,4265,1267,126486
19/6/21,Estonia,130781,67.56,23312.28,4150,1267,126631
20/6/21,Estonia,130806,67.87,23312.28,4142,1268,126664
21/6/21,Estonia,130818,68.52,23312.28,4122,1268,126696
22/6/21,Estonia,130855,68.96,23312.28,4057,1269,126798
23/6/21,Estonia,130880,68.97,23312.28,3970,1269,126910
24/6/21,Estonia,130898,68.98,23312.28,3930,1269,126968
25/6/21,Estonia,130908,69.56,23312.28,3862,1269,127046
26/6/21,Estonia,130941,69.89,23312.28,3811,1269,127130
27/6/21,Estonia,130968,70.23,23312.28,3819,1269,127149
28/6/21,Estonia,130983,70.79,23312.28,3822,1269,127161
29/6/21,Estonia,131028,71.43,23312.28,3808,1269,127220
30/6/21,Estonia,131064,72.09,23312.28,3713,1269,127351
1/2/21,Czechia,987329,2.73,22762.2,112016,16392,875313
2/2/21,Czechia,994514,2.87,22762.2,109235,16545,885279
3/2/21,Czechia,1003657,3.01,22762.2,109726,16683,893931
4/2/21,Czechia,1013352,3.18,22762.2,111345,16826,902007
5/2/21,Czechia,1021477,3.33,22762.2,112172,16976,909305
6/2/21,Czechia,1030112,3.36,22762.2,113323,17129,916789
7/2/21,Czechia,1034975,3.39,22762.2,115276,17235,919699
8/2/21,Czechia,1037405,3.53,22762.2,115182,17333,922223
9/2/21,Czechia,1045132,3.69,22762.2,112976,17497,932156
10/2/21,Czechia,1055415,3.86,22762.2,114401,17642,941014
11/2/21,Czechia,1064952,4.07,22762.2,116156,17772,948796
12/2/21,Czechia,1073966,4.27,22762.2,118028,17902,955938
13/2/21,Czechia,1082849,4.32,22762.2,119142,18058,963707
14/2/21,Czechia,1088009,4.34,22762.2,121610,18143,966399
15/2/21,Czechia,1090860,4.49,22762.2,121706,18250,969154
16/2/21,Czechia,1099654,4.65,22762.2,120905,18430,978749
17/2/21,Czechia,1112322,4.82,22762.2,124807,18596,987515
18/2/21,Czechia,1123252,5.01,22762.2,127266,18739,995986
19/2/21,Czechia,1134957,5.19,22762.2,131218,18913,1003739
20/2/21,Czechia,1146321,5.22,22762.2,134227,19097,1012094
21/2/21,Czechia,1153159,5.24,22762.2,138162,19214,1014997
22/2/21,Czechia,1157180,5.39,22762.2,139774,19330,1017406
23/2/21,Czechia,1168491,5.57,22762.2,140360,19537,1028131
24/2/21,Czechia,1184352,5.76,22762.2,146922,19682,1037430
25/2/21,Czechia,1198168,5.98,22762.2,151593,19835,1046575
26/2/21,Czechia,1212780,6.18,22762.2,157697,19999,1055083
27/2/21,Czechia,1227595,6.21,22762.2,163573,20194,1064022
28/2/21,Czechia,1235480,6.24,22762.2,167923,20339,1067557
1/3/21,Czechia,1240051,6.45,22762.2,169429,20469,1070622
2/3/21,Czechia,1252242,6.74,22762.2,169625,20701,1082617
3/3/21,Czechia,1269058,7.07,22762.2,175521,20941,1093537
4/3/21,Czechia,1284288,7.42,22762.2,179696,21128,1104592
5/3/21,Czechia,1299002,7.74,22762.2,183830,21325,1115172
6/3/21,Czechia,1312164,7.86,22762.2,185744,21558,1126420
7/3/21,Czechia,1321331,7.98,22762.2,190122,21717,1131209
8/3/21,Czechia,1325291,8.3,22762.2,190040,21882,1135251
9/3/21,Czechia,1335815,8.7,22762.2,185181,22147,1150634
10/3/21,Czechia,1351195,9.15,22762.2,186197,22385,1164998
11/3/21,Czechia,1365724,9.65,22762.2,186892,22624,1178832
12/3/21,Czechia,1376998,10.09,22762.2,185216,22865,1191782
13/3/21,Czechia,1392108,10.26,22762.2,187237,23083,1204871
14/3/21,Czechia,1399078,10.38,22762.2,189279,23226,1209799
15/3/21,Czechia,1402420,10.73,22762.2,188364,23379,1214056
16/3/21,Czechia,1412962,11.19,22762.2,198432,23657,1214530
17/3/21,Czechia,1426991,11.63,22762.2,211914,23902,1215077
18/3/21,Czechia,1439019,12.1,22762.2,223475,24117,1215544
19/3/21,Czechia,1449696,12.55,22762.2,232746,24331,1216950
20/3/21,Czechia,1459406,12.71,22762.2,225637,24530,1233769
21/3/21,Czechia,1469547,12.79,22762.2,216238,24667,1253309
22/3/21,Czechia,1467333,13.14,22762.2,204595,24810,1262738
23/3/21,Czechia,1475538,13.51,22762.2,199050,25055,1276488
24/3/21,Czechia,1486510,13.91,22762.2,196586,25258,1289924
25/3/21,Czechia,1495361,14.32,22762.2,200156,25450,1295205
26/3/21,Czechia,1503307,14.71,22762.2,203755,25639,1299552
27/3/21,Czechia,1511021,14.84,22762.2,211091,25778,1299930
28/3/21,Czechia,1515029,14.93,22762.2,199458,25874,1315571
29/3/21,Czechia,1516772,15.3,22762.2,174659,26036,1342113
30/3/21,Czechia,1523668,15.74,22762.2,169244,26222,1354424
31/3/21,Czechia,1532332,16.2,22762.2,165871,26421,1366461
1/4/21,Czechia,1539617,16.74,22762.2,168543,26586,1371074
2/4/21,Czechia,1545865,16.92,22762.2,171042,26765,1374823
3/4/21,Czechia,1549734,17.06,22762.2,160545,26867,1389189
4/4/21,Czechia,1551896,17.17,22762.2,150596,26945,1401300
5/4/21,Czechia,1553820,17.26,22762.2,142072,27057,1411748
6/4/21,Czechia,1555245,17.68,22762.2,133961,27169,1421284
7/4/21,Czechia,1560777,18.1,22762.2,129961,27329,1430816
8/4/21,Czechia,1567848,18.75,22762.2,133567,27466,1434281
9/4/21,Czechia,1573153,19.4,22762.2,135858,27617,1437295
10/4/21,Czechia,1577972,19.69,22762.2,129129,27734,1448843
11/4/21,Czechia,1580189,19.87,22762.2,131137,27808,1449052
12/4/21,Czechia,1581184,20.46,22762.2,114888,27918,1466296
13/4/21,Czechia,1585037,21.04,22762.2,111554,28038,1473483
14/4/21,Czechia,1590124,21.66,22762.2,109242,28124,1480882
15/4/21,Czechia,1593847,22.35,22762.2,110288,28229,1483559
16/4/21,Czechia,1597103,23,22762.2,111179,28317,1485924
17/4/21,Czechia,1600341,23.24,22762.2,104771,28396,1495570
18/4/21,Czechia,1601881,23.41,22762.2,106257,28426,1495624
19/4/21,Czechia,1602711,23.96,22762.2,93729,28532,1508982
20/4/21,Czechia,1606030,24.51,22762.2,90924,28640,1515106
21/4/21,Czechia,1609861,25.08,22762.2,92087,28711,1517774
22/4/21,Czechia,1612832,25.75,22762.2,92569,28787,1520263
23/4/21,Czechia,1615461,26.33,22762.2,93000,28863,1522461
24/4/21,Czechia,1618068,26.54,22762.2,94027,28920,1524041
25/4/21,Czechia,1619383,26.72,22762.2,95237,28962,1524146
26/4/21,Czechia,1620206,27.25,22762.2,82844,29002,1537362
27/4/21,Czechia,1622777,27.81,22762.2,80814,29075,1541963
28/4/21,Czechia,1626033,28.47,22762.2,83789,29141,1542244
29/4/21,Czechia,1628536,29.22,22762.2,80522,29213,1548014
30/4/21,Czechia,1630758,29.87,22762.2,81319,29267,1549439
1/5/21,Czechia,1632932,30.09,22762.2,77780,29316,1555152
2/5/21,Czechia,1634114,30.28,22762.2,78899,29343,1555215
3/5/21,Czechia,1634619,30.95,22762.2,72324,29365,1562295
4/5/21,Czechia,1636836,31.63,22762.2,71355,29421,1565481
5/5/21,Czechia,1639248,32.38,22762.2,70618,29479,1568630
6/5/21,Czechia,1641120,33.21,22762.2,71258,29521,1569862
7/5/21,Czechia,1642696,34.01,22762.2,71854,29608,1570842
8/5/21,Czechia,1644335,34.3,22762.2,68936,29647,1575399
9/5/21,Czechia,1645061,34.53,22762.2,69612,29667,1575449
10/5/21,Czechia,1645448,35.26,22762.2,64509,29711,1580939
11/5/21,Czechia,1646981,36.04,22762.2,63391,29749,1583590
12/5/21,Czechia,1648667,36.85,22762.2,62267,29787,1586400
13/5/21,Czechia,1649947,37.7,22762.2,62490,29825,1587457
14/5/21,Czechia,1651178,38.51,22762.2,62832,29857,1588346
15/5/21,Czechia,1652238,38.82,22762.2,60019,29886,1592219
16/5/21,Czechia,1652840,39.07,22762.2,60577,29901,1592263
17/5/21,Czechia,1653099,39.8,22762.2,56168,29913,1596931
18/5/21,Czechia,1654219,40.59,22762.2,54338,29933,1599881
19/5/21,Czechia,1655414,41.44,22762.2,53296,29948,1602118
20/5/21,Czechia,1656202,42.38,22762.2,53228,29967,1602974
21/5/21,Czechia,1656874,43.26,22762.2,53110,29990,1603764
22/5/21,Czechia,1657558,43.67,22762.2,49877,30012,1607681
23/5/21,Czechia,1657893,43.96,22762.2,50187,30020,1607706
24/5/21,Czechia,1658092,44.7,22762.2,46903,30028,1611189
25/5/21,Czechia,1658778,45.5,22762.2,45947,30041,1612831
26/5/21,Czechia,1659433,46.46,22762.2,45028,30054,1614405
27/5/21,Czechia,1659980,47.46,22762.2,45065,30059,1614915
28/5/21,Czechia,1660481,48.45,22762.2,45473,30088,1615008
29/5/21,Czechia,1660935,48.88,22762.2,43437,30101,1617498
30/5/21,Czechia,1661159,49.22,22762.2,43642,30104,1617517
31/5/21,Czechia,1661272,50.16,22762.2,41174,30108,1620098
1/6/21,Czechia,1661780,51.15,22762.2,40518,30119,1621262
2/6/21,Czechia,1662256,52.21,22762.2,39824,30126,1622432
3/6/21,Czechia,1662608,53.29,22762.2,39732,30136,1622876
4/6/21,Czechia,1663040,54.38,22762.2,39754,30142,1623286
5/6/21,Czechia,1663363,54.88,22762.2,38651,30157,1624712
6/6/21,Czechia,1663517,55.27,22762.2,38796,30159,1624721
7/6/21,Czechia,1663607,56.35,22762.2,37301,30164,1626306
8/6/21,Czechia,1663998,57.43,22762.2,36892,30193,1627106
9/6/21,Czechia,1664382,58.55,22762.2,37231,30202,1627151
10/6/21,Czechia,1664649,59.68,22762.2,36479,30211,1628170
11/6/21,Czechia,1664839,60.79,22762.2,36423,30219,1628416
12/6/21,Czechia,1665022,61.28,22762.2,35647,30224,1629375
13/6/21,Czechia,1665097,61.67,22762.2,35718,30225,1629379
14/6/21,Czechia,1665138,62.75,22762.2,34686,30229,1630452
15/6/21,Czechia,1665327,63.82,22762.2,34389,30229,1630938
16/6/21,Czechia,1665526,64.92,22762.2,34549,30254,1630977
17/6/21,Czechia,1665660,66.04,22762.2,34633,30257,1631027
18/6/21,Czechia,1665818,67.17,22762.2,34194,30275,1631624
19/6/21,Czechia,1665961,67.64,22762.2,34299,30278,1631662
20/6/21,Czechia,1666025,68.02,22762.2,33185,30280,1632840
21/6/21,Czechia,1666082,69.04,22762.2,32920,30280,1633162
22/6/21,Czechia,1666192,70.1,22762.2,32710,30283,1633482
23/6/21,Czechia,1666325,71.18,22762.2,32775,30289,1633550
24/6/21,Czechia,1666521,72.28,22762.2,32511,30291,1634010
25/6/21,Czechia,1666686,73.35,22762.2,32394,30292,1634292
26/6/21,Czechia,1666821,73.82,22762.2,32087,30296,1634734
27/6/21,Czechia,1666890,74.2,22762.2,32151,30298,1634739
28/6/21,Czechia,1666947,75.25,22762.2,31764,30298,1635183
29/6/21,Czechia,1667115,76.31,22762.2,31708,30298,1635407
30/6/21,Czechia,1667287,77.4,22762.2,31708,30303,1635579
1/2/21,Slovakia,439325,2.95,19156.89,220402,4711,218923
2/2/21,Slovakia,444562,3.17,19156.89,221920,4784,222642
3/2/21,Slovakia,451043,3.39,19156.89,224572,4889,226471
4/2/21,Slovakia,455693,3.65,19156.89,225237,4976,230456
5/2/21,Slovakia,461246,3.93,19156.89,226875,5050,234371
6/2/21,Slovakia,466535,3.98,19156.89,228314,5135,238221
7/2/21,Slovakia,473575,3.98,19156.89,231889,5199,241686
8/2/21,Slovakia,477647,4.2,19156.89,231945,5271,245702
9/2/21,Slovakia,483002,4.47,19156.89,234616,5382,248386
10/2/21,Slovakia,489218,4.7,19156.89,237600,5502,251618
11/2/21,Slovakia,494688,4.96,19156.89,241170,5629,253518
12/2/21,Slovakia,499593,5.22,19156.89,244293,5733,255300
13/2/21,Slovakia,505266,5.3,19156.89,249966,5812,255300
14/2/21,Slovakia,511547,5.49,19156.89,256247,5885,255300
15/2/21,Slovakia,515038,5.74,19156.89,259738,5952,255300
16/2/21,Slovakia,519763,5.95,19156.89,264463,6063,255300
17/2/21,Slovakia,525692,6.16,19156.89,270392,6168,255300
18/2/21,Slovakia,531043,6.37,19156.89,275743,6271,255300
19/2/21,Slovakia,536173,6.61,19156.89,280873,6350,255300
20/2/21,Slovakia,542452,6.73,19156.89,287152,6424,255300
21/2/21,Slovakia,549434,6.85,19156.89,294134,6505,255300
22/2/21,Slovakia,552972,7.08,19156.89,297672,6577,255300
23/2/21,Slovakia,558407,7.31,19156.89,303107,6671,255300
24/2/21,Slovakia,564839,7.55,19156.89,309539,6775,255300
25/2/21,Slovakia,570287,7.75,19156.89,314987,6859,255300
26/2/21,Slovakia,575542,7.99,19156.89,320242,6966,255300
27/2/21,Slovakia,581724,8.14,19156.89,326424,7075,255300
28/2/21,Slovakia,588671,8.24,19156.89,333371,7189,255300
1/3/21,Slovakia,592135,8.52,19156.89,336835,7270,255300
2/3/21,Slovakia,597397,8.8,19156.89,342097,7388,255300
3/3/21,Slovakia,603500,9.05,19156.89,348200,7489,255300
4/3/21,Slovakia,608790,9.29,19156.89,353490,7560,255300
5/3/21,Slovakia,613613,9.53,19156.89,358313,7665,255300
6/3/21,Slovakia,618978,9.85,19156.89,363678,7739,255300
7/3/21,Slovakia,624188,10.03,19156.89,368888,7836,255300
8/3/21,Slovakia,626882,10.28,19156.89,371582,7921,255300
9/3/21,Slovakia,631700,10.48,19156.89,376400,8037,255300
10/3/21,Slovakia,637344,10.67,19156.89,382044,8146,255300
11/3/21,Slovakia,641295,11,19156.89,385995,8244,255300
12/3/21,Slovakia,645457,11.37,19156.89,390157,8346,255300
13/3/21,Slovakia,650209,11.73,19156.89,394909,8440,255300
14/3/21,Slovakia,654912,11.99,19156.89,399612,8528,255300
15/3/21,Slovakia,657214,12.33,19156.89,401914,8605,255300
16/3/21,Slovakia,661025,12.68,19156.89,405725,8669,255300
17/3/21,Slovakia,665746,13.04,19156.89,410446,8738,255300
18/3/21,Slovakia,669337,13.42,19156.89,414037,8814,255300
19/3/21,Slovakia,672631,13.79,19156.89,417331,8894,255300
20/3/21,Slovakia,676460,14.16,19156.89,421160,8978,255300
21/3/21,Slovakia,680076,14.44,19156.89,424776,9044,255300
22/3/21,Slovakia,682042,14.83,19156.89,426742,9104,255300
23/3/21,Slovakia,685094,15.25,19156.89,429794,9190,255300
24/3/21,Slovakia,688587,15.67,19156.89,433287,9261,255300
25/3/21,Slovakia,691648,16.04,19156.89,436348,9313,255300
26/3/21,Slovakia,694284,16.39,19156.89,438984,9373,255300
27/3/21,Slovakia,697479,16.66,19156.89,442179,9426,255300
28/3/21,Slovakia,700607,16.83,19156.89,445307,9496,255300
29/3/21,Slovakia,702117,17.2,19156.89,446817,9542,255300
30/3/21,Slovakia,704811,17.58,19156.89,449511,9624,255300
31/3/21,Slovakia,707876,17.99,19156.89,452576,9719,255300
1/4/21,Slovakia,710422,18.4,19156.89,455122,9790,255300
2/4/21,Slovakia,713050,18.48,19156.89,457750,9877,255300
3/4/21,Slovakia,714421,18.69,19156.89,459121,9948,255300
4/4/21,Slovakia,716997,18.77,19156.89,461697,10025,255300
5/4/21,Slovakia,717704,18.77,19156.89,462404,10094,255300
6/4/21,Slovakia,718676,19.14,19156.89,463376,10094,255300
7/4/21,Slovakia,721316,19.56,19156.89,466016,10243,255300
8/4/21,Slovakia,723860,19.99,19156.89,468560,10322,255300
9/4/21,Slovakia,725589,20.46,19156.89,470289,10411,255300
10/4/21,Slovakia,727606,20.84,19156.89,472306,10487,255300
11/4/21,Slovakia,729587,21.23,19156.89,474287,10565,255300
12/4/21,Slovakia,730428,21.64,19156.89,475128,10630,255300
13/4/21,Slovakia,732212,22.03,19156.89,476912,10716,255300
14/4/21,Slovakia,733974,22.42,19156.89,478674,10798,255300
15/4/21,Slovakia,735497,22.86,19156.89,480197,10877,255300
16/4/21,Slovakia,736807,23.34,19156.89,481507,10970,255300
17/4/21,Slovakia,738393,23.83,19156.89,483093,11043,255300
18/4/21,Slovakia,740038,24.06,19156.89,484738,11106,255300
19/4/21,Slovakia,740766,24.45,19156.89,485466,11172,255300
20/4/21,Slovakia,742236,24.86,19156.89,486936,11244,255300
21/4/21,Slovakia,743647,25.25,19156.89,488347,11304,255300
22/4/21,Slovakia,744982,25.67,19156.89,489682,11357,255300
23/4/21,Slovakia,746030,26.09,19156.89,490730,11405,255300
24/4/21,Slovakia,747566,26.48,19156.89,492266,11458,255300
25/4/21,Slovakia,748935,26.82,19156.89,493635,11495,255300
26/4/21,Slovakia,749627,27.29,19156.89,494327,11531,255300
27/4/21,Slovakia,750817,27.68,19156.89,495517,11572,255300
28/4/21,Slovakia,752009,28.08,19156.89,496709,11611,255300
29/4/21,Slovakia,753075,28.53,19156.89,497775,11647,255300
30/4/21,Slovakia,754078,29.04,19156.89,498778,11684,255300
1/5/21,Slovakia,755233,29.59,19156.89,499933,11732,255300
2/5/21,Slovakia,756249,29.97,19156.89,500949,11766,255300
3/5/21,Slovakia,756876,30.39,19156.89,501576,11807,255300
4/5/21,Slovakia,757806,30.84,19156.89,502506,11855,255300
5/5/21,Slovakia,758896,31.29,19156.89,503596,11886,255300
6/5/21,Slovakia,759611,31.76,19156.89,504311,11920,255300
7/5/21,Slovakia,760362,32.31,19156.89,505062,11946,255300
8/5/21,Slovakia,761194,33.14,19156.89,505894,11990,255300
9/5/21,Slovakia,761546,33.73,19156.89,506246,12019,255300
10/5/21,Slovakia,762257,34.31,19156.89,506957,12051,255300
11/5/21,Slovakia,763041,34.87,19156.89,507741,12077,255300
12/5/21,Slovakia,763714,35.41,19156.89,508414,12096,255300
13/5/21,Slovakia,764321,35.97,19156.89,509021,12135,255300
14/5/21,Slovakia,764881,36.63,19156.89,509581,12168,255300
15/5/21,Slovakia,765492,37.44,19156.89,510192,12203,255300
16/5/21,Slovakia,765867,38.03,19156.89,510567,12224,255300
17/5/21,Slovakia,766253,38.65,19156.89,510953,12238,255300
18/5/21,Slovakia,766804,39.21,19156.89,511504,12248,255300
19/5/21,Slovakia,767276,39.78,19156.89,511976,12262,255300
20/5/21,Slovakia,767731,40.43,19156.89,512431,12272,255300
21/5/21,Slovakia,768041,41.14,19156.89,512741,12280,255300
22/5/21,Slovakia,768439,42.01,19156.89,513139,12286,255300
23/5/21,Slovakia,768747,42.63,19156.89,513447,12292,255300
24/5/21,Slovakia,768955,43.24,19156.89,513655,12296,255300
25/5/21,Slovakia,769351,43.81,19156.89,514051,12301,255300
26/5/21,Slovakia,769748,44.34,19156.89,514448,12312,255300
27/5/21,Slovakia,770058,45.02,19156.89,514758,12320,255300
28/5/21,Slovakia,770311,45.64,19156.89,515011,12333,255300
29/5/21,Slovakia,770629,46.56,19156.89,515329,12333,255300
30/5/21,Slovakia,770851,47.24,19156.89,515551,12339,255300
31/5/21,Slovakia,771008,47.87,19156.89,515708,12343,255300
1/6/21,Slovakia,771363,48.41,19156.89,516063,12353,255300
2/6/21,Slovakia,771621,48.92,19156.89,516321,12366,255300
3/6/21,Slovakia,771879,49.53,19156.89,516579,12375,255300
4/6/21,Slovakia,772106,50.16,19156.89,516806,12382,255300
5/6/21,Slovakia,772358,51.04,19156.89,517058,12395,255300
6/6/21,Slovakia,772528,51.69,19156.89,517228,12404,255300
7/6/21,Slovakia,772630,52.3,19156.89,517330,12414,255300
8/6/21,Slovakia,772873,52.84,19156.89,517573,12423,255300
9/6/21,Slovakia,773114,53.36,19156.89,517814,12430,255300
10/6/21,Slovakia,773280,54,19156.89,517980,12433,255300
11/6/21,Slovakia,773436,54.66,19156.89,518136,12433,255300
12/6/21,Slovakia,773611,55.48,19156.89,518311,12436,255300
13/6/21,Slovakia,773710,56.15,19156.89,518410,12439,255300
14/6/21,Slovakia,773779,56.72,19156.89,518479,12441,255300
15/6/21,Slovakia,773906,57.25,19156.89,518606,12446,255300
16/6/21,Slovakia,774015,57.78,19156.89,518715,12456,255300
17/6/21,Slovakia,774115,58.43,19156.89,518815,12464,255300
18/6/21,Slovakia,774196,59.12,19156.89,518896,12478,255300
19/6/21,Slovakia,774299,59.97,19156.89,518999,12478,255300
20/6/21,Slovakia,774350,60.7,19156.89,519050,12478,255300
21/6/21,Slovakia,774392,61.32,19156.89,519092,12496,255300
22/6/21,Slovakia,774510,61.92,19156.89,519210,12502,255300
23/6/21,Slovakia,774575,62.46,19156.89,519275,12502,255300
24/6/21,Slovakia,774642,63.13,19156.89,519342,12502,255300
25/6/21,Slovakia,774712,63.81,19156.89,519412,12505,255300
26/6/21,Slovakia,774786,64.57,19156.89,519486,12505,255300
27/6/21,Slovakia,774838,65.13,19156.89,519538,12505,255300
28/6/21,Slovakia,774875,65.61,19156.89,519575,12509,255300
29/6/21,Slovakia,774954,66.13,19156.89,519654,12510,255300
30/6/21,Slovakia,775011,66.66,19156.89,519711,12510,255300
1/2/21,Norway,63262,2.44,67294.48,45264,567,17998
2/2/21,Norway,63553,2.62,67294.48,45555,568,17998
3/2/21,Norway,63839,3.24,67294.48,45841,574,17998
4/2/21,Norway,64212,3.89,67294.48,46214,582,17998
5/2/21,Norway,64483,4.18,67294.48,46485,582,17998
6/2/21,Norway,64653,4.21,67294.48,46655,582,17998
7/2/21,Norway,64772,4.22,67294.48,46774,582,17998
8/2/21,Norway,65118,4.24,67294.48,47120,582,17998
9/2/21,Norway,65338,4.41,67294.48,47340,583,17998
10/2/21,Norway,65547,5,67294.48,47549,592,17998
11/2/21,Norway,65811,5.55,67294.48,47813,592,17998
12/2/21,Norway,66236,5.77,67294.48,48238,592,17998
13/2/21,Norway,66392,5.79,67294.48,48394,592,17998
14/2/21,Norway,66501,5.8,67294.48,48503,592,17998
15/2/21,Norway,66854,5.83,67294.48,48856,593,17998
16/2/21,Norway,67140,5.98,67294.48,49142,593,17998
17/2/21,Norway,67498,6.58,67294.48,49500,607,17998
18/2/21,Norway,67824,7.14,67294.48,49826,607,17998
19/2/21,Norway,68107,7.42,67294.48,50109,607,17998
20/2/21,Norway,68315,7.44,67294.48,50317,607,17998
21/2/21,Norway,68532,7.44,67294.48,50534,607,17998
22/2/21,Norway,68758,7.5,67294.48,50760,608,17998
23/2/21,Norway,69148,7.71,67294.48,51150,608,17998
24/2/21,Norway,69489,8.34,67294.48,51491,620,17998
25/2/21,Norway,70040,9.03,67294.48,52042,620,17998
26/2/21,Norway,70564,9.38,67294.48,52566,622,17998
27/2/21,Norway,70826,9.39,67294.48,52828,622,17998
28/2/21,Norway,71006,9.4,67294.48,53008,622,17998
1/3/21,Norway,71735,9.52,67294.48,53737,623,17998
2/3/21,Norway,72234,9.79,67294.48,54236,623,17998
3/3/21,Norway,72923,10.46,67294.48,54925,632,17998
4/3/21,Norway,73493,11.11,67294.48,55495,632,17998
5/3/21,Norway,74183,11.46,67294.48,56185,632,17998
6/3/21,Norway,74546,11.48,67294.48,56548,632,17998
7/3/21,Norway,74942,11.48,67294.48,56944,632,17998
8/3/21,Norway,75770,11.58,67294.48,57772,632,17998
9/3/21,Norway,76484,11.89,67294.48,58486,632,17998
10/3/21,Norway,77169,12.62,67294.48,59171,632,17998
11/3/21,Norway,78041,13.16,67294.48,60043,639,17998
12/3/21,Norway,78946,13.36,67294.48,60948,639,17998
13/3/21,Norway,79800,13.37,67294.48,61802,639,17998
14/3/21,Norway,80440,13.37,67294.48,62442,639,17998
15/3/21,Norway,81305,13.38,67294.48,63307,640,17998
16/3/21,Norway,82455,13.51,67294.48,64457,641,17998
17/3/21,Norway,83519,13.97,67294.48,65521,648,17998
18/3/21,Norway,84553,14.4,67294.48,66555,648,17998
19/3/21,Norway,85542,14.54,67294.48,67544,648,17998
20/3/21,Norway,86362,14.56,67294.48,68364,648,17998
21/3/21,Norway,86939,14.56,67294.48,68941,648,17998
22/3/21,Norway,88035,14.6,67294.48,70037,649,17998
23/3/21,Norway,89120,14.86,67294.48,71122,649,17998
24/3/21,Norway,90104,15.66,67294.48,72106,656,17998
25/3/21,Norway,90935,16.43,67294.48,72937,656,17998
26/3/21,Norway,92007,16.78,67294.48,74009,656,17998
27/3/21,Norway,92469,16.79,67294.48,74471,656,17998
28/3/21,Norway,93150,16.8,67294.48,75152,656,17998
29/3/21,Norway,94139,16.89,67294.48,76141,660,17998
30/3/21,Norway,95208,17.58,67294.48,77210,661,17998
31/3/21,Norway,96079,18.41,67294.48,78081,673,17998
1/4/21,Norway,96770,18.61,67294.48,78772,673,17998
2/4/21,Norway,97410,18.71,67294.48,79412,673,17998
3/4/21,Norway,98102,18.72,67294.48,80104,673,17998
4/4/21,Norway,98676,18.73,67294.48,80678,673,17998
5/4/21,Norway,99249,18.76,67294.48,81251,676,17998
6/4/21,Norway,100149,19.16,67294.48,82151,677,17998
7/4/21,Norway,101082,20.32,67294.48,83084,683,17998
8/4/21,Norway,101960,21.46,67294.48,83962,684,17998
9/4/21,Norway,102719,21.99,67294.48,84721,684,17998
10/4/21,Norway,102974,22.01,67294.48,84976,684,17998
11/4/21,Norway,103621,22.02,67294.48,85623,684,17998
12/4/21,Norway,104269,22.1,67294.48,86271,687,17998
13/4/21,Norway,105008,22.58,67294.48,87010,688,17998
14/4/21,Norway,105607,23.86,67294.48,87609,706,17998
15/4/21,Norway,106224,25.09,67294.48,88226,707,17998
16/4/21,Norway,106727,25.65,67294.48,88729,708,17998
17/4/21,Norway,107144,25.69,67294.48,89146,708,17998
18/4/21,Norway,107510,25.72,67294.48,89512,708,17998
19/4/21,Norway,108028,25.84,67294.48,90030,709,17998
20/4/21,Norway,108342,26.22,67294.48,90344,709,17998
21/4/21,Norway,109137,27.38,67294.48,91139,734,17998
22/4/21,Norway,109581,28.37,67294.48,91583,735,17998
23/4/21,Norway,110061,28.74,67294.48,92063,736,17998
24/4/21,Norway,110390,28.75,67294.48,92392,736,17998
25/4/21,Norway,110612,28.76,67294.48,92614,736,17998
26/4/21,Norway,111162,28.81,67294.48,93164,736,17998
27/4/21,Norway,111686,29.29,67294.48,93688,736,17998
28/4/21,Norway,112156,30.83,67294.48,94158,753,17998
29/4/21,Norway,112541,32.22,67294.48,94543,754,17998
30/4/21,Norway,112970,32.84,67294.48,94972,756,17998
1/5/21,Norway,113259,32.88,67294.48,95261,756,17998
2/5/21,Norway,113469,32.9,67294.48,95471,756,17998
3/5/21,Norway,113952,32.99,67294.48,95954,757,17998
4/5/21,Norway,114436,33.41,67294.48,96438,757,17998
5/5/21,Norway,114905,34.87,67294.48,96907,767,17998
6/5/21,Norway,115411,36.18,67294.48,97413,767,17998
7/5/21,Norway,115818,36.76,67294.48,97820,767,17998
8/5/21,Norway,116134,36.79,67294.48,98136,767,17998
9/5/21,Norway,116365,36.8,67294.48,98367,767,17998
10/5/21,Norway,117022,36.97,67294.48,99024,767,17998
11/5/21,Norway,117495,37.88,67294.48,99497,767,17998
12/5/21,Norway,117995,39.64,67294.48,99997,774,17998
13/5/21,Norway,118315,40.04,67294.48,100317,774,17998
14/5/21,Norway,118740,40.4,67294.48,100742,774,17998
15/5/21,Norway,119052,40.46,67294.48,101054,774,17998
16/5/21,Norway,119299,40.5,67294.48,101301,774,17998
17/5/21,Norway,119500,40.51,67294.48,101502,774,17998
18/5/21,Norway,119814,41.04,67294.48,101816,774,17998
19/5/21,Norway,120292,42.52,67294.48,102294,781,17998
20/5/21,Norway,120797,43.95,67294.48,102799,781,17998
21/5/21,Norway,121511,44.62,67294.48,103513,781,17998
22/5/21,Norway,121963,44.66,67294.48,103965,781,17998
23/5/21,Norway,122414,44.68,67294.48,104416,781,17998
24/5/21,Norway,122652,44.75,67294.48,104654,782,17998
25/5/21,Norway,123163,45.36,67294.48,105165,782,17998
26/5/21,Norway,123662,47.09,67294.48,105664,783,17998
27/5/21,Norway,124071,48.62,67294.48,106073,783,17998
28/5/21,Norway,124410,49.31,67294.48,106412,783,17998
29/5/21,Norway,124655,49.36,67294.48,106657,783,17998
30/5/21,Norway,124824,49.39,67294.48,106826,783,17998
31/5/21,Norway,125116,49.58,67294.48,107118,783,17998
1/6/21,Norway,125576,50.35,67294.48,107578,783,17998
2/6/21,Norway,125929,52.62,67294.48,107931,785,17998
3/6/21,Norway,126218,54.71,67294.48,108220,785,17998
4/6/21,Norway,126521,55.66,67294.48,108523,785,17998
5/6/21,Norway,126689,55.74,67294.48,108691,785,17998
6/6/21,Norway,126817,55.8,67294.48,108819,785,17998
7/6/21,Norway,127066,56.15,67294.48,109068,784,17998
8/6/21,Norway,127254,57.01,67294.48,109256,784,17998
9/6/21,Norway,127466,58.86,67294.48,109468,789,17998
10/6/21,Norway,127676,60.61,67294.48,109678,789,17998
11/6/21,Norway,127874,61.4,67294.48,109876,789,17998
12/6/21,Norway,127986,61.47,67294.48,109988,789,17998
13/6/21,Norway,128046,61.53,67294.48,110048,789,17998
14/6/21,Norway,128277,61.94,67294.48,110279,789,17998
15/6/21,Norway,128499,62.67,67294.48,110501,789,17998
16/6/21,Norway,128679,64.61,67294.48,110681,790,17998
17/6/21,Norway,128898,66.31,67294.48,110900,790,17998
18/6/21,Norway,129095,67.13,67294.48,111097,790,17998
19/6/21,Norway,129225,67.26,67294.48,111227,790,17998
20/6/21,Norway,129333,67.34,67294.48,111335,790,17998
21/6/21,Norway,129545,67.72,67294.48,111547,790,17998
22/6/21,Norway,129766,68.65,67294.48,111768,790,17998
23/6/21,Norway,129944,70.67,67294.48,111946,792,17998
24/6/21,Norway,130270,72.75,67294.48,112272,792,17998
25/6/21,Norway,130342,73.75,67294.48,112344,792,17998
26/6/21,Norway,130491,73.94,67294.48,112493,792,17998
27/6/21,Norway,130588,74.05,67294.48,112590,792,17998
28/6/21,Norway,130744,74.66,67294.48,112746,792,17998
29/6/21,Norway,131037,75.61,67294.48,113039,792,17998
30/6/21,Norway,131316,77.66,67294.48,113318,794,17998
1/2/21,Argentina,1933853,0.82,8441.92,203854,48249,1729999
2/2/21,Argentina,1943548,0.85,8441.92,204780,48426,1738768
3/2/21,Argentina,1952744,0.87,8441.92,207536,48539,1745208
4/2/21,Argentina,1961635,0.97,8441.92,206930,48700,1754705
5/2/21,Argentina,1970009,1,8441.92,206247,48985,1763762
6/2/21,Argentina,1976689,1.03,8441.92,204630,49110,1772059
7/2/21,Argentina,1980347,1.1,8441.92,201382,49171,1778965
8/2/21,Argentina,1985501,1.12,8441.92,199323,49398,1786178
9/2/21,Argentina,1993295,1.13,8441.92,200974,49566,1792321
10/2/21,Argentina,2001034,1.17,8441.92,202914,49674,1798120
11/2/21,Argentina,2008345,1.26,8441.92,202085,49874,1806260
12/2/21,Argentina,2015496,1.3,8441.92,201336,50029,1814160
13/2/21,Argentina,2021553,1.33,8441.92,200588,50188,1820965
14/2/21,Argentina,2025798,1.34,8441.92,198680,50236,1827118
15/2/21,Argentina,2029057,1.34,8441.92,195615,50327,1833442
16/2/21,Argentina,2033060,1.34,8441.92,194769,50432,1838291
17/2/21,Argentina,2039124,1.34,8441.92,196246,50616,1842878
18/2/21,Argentina,2046795,1.39,8441.92,197344,50857,1849451
19/2/21,Argentina,2054681,1.47,8441.92,199036,51000,1855645
20/2/21,Argentina,2060625,1.55,8441.92,199192,51122,1861433
21/2/21,Argentina,2064334,1.58,8441.92,197833,51198,1866501
22/2/21,Argentina,2069751,1.58,8441.92,197538,51359,1872213
23/2/21,Argentina,2077228,1.64,8441.92,199330,51510,1877898
24/2/21,Argentina,2085411,1.71,8441.92,202843,51650,1882568
25/2/21,Argentina,2093645,1.82,8441.92,206913,51795,1886732
26/2/21,Argentina,2098728,1.98,8441.92,205894,51887,1892834
27/2/21,Argentina,2104197,2.16,8441.92,205110,51946,1899087
28/2/21,Argentina,2107365,2.25,8441.92,202344,51965,1905021
1/3/21,Argentina,2112023,2.3,8441.92,200685,52077,1911338
2/3/21,Argentina,2118676,2.47,8441.92,201740,52192,1916936
3/3/21,Argentina,2126531,2.59,8441.92,204942,52453,1921589
4/3/21,Argentina,2133963,2.75,8441.92,205586,52644,1928377
5/3/21,Argentina,2141854,2.98,8441.92,207009,52784,1934845
6/3/21,Argentina,2146714,3.01,8441.92,206397,52870,1940317
7/3/21,Argentina,2149636,3.35,8441.92,203820,52880,1945816
8/3/21,Argentina,2154694,3.39,8441.92,203154,53121,1951540
9/3/21,Argentina,2162001,3.62,8441.92,205410,53252,1956591
10/3/21,Argentina,2169694,3.89,8441.92,208054,53359,1961640
11/3/21,Argentina,2177898,4.21,8441.92,209436,53493,1968462
12/3/21,Argentina,2185747,4.6,8441.92,210881,53578,1974866
13/3/21,Argentina,2192025,5.03,8441.92,210868,53646,1981157
14/3/21,Argentina,2195722,5.22,8441.92,208819,53670,1986903
15/3/21,Argentina,2201886,5.27,8441.92,208671,53836,1993215
16/3/21,Argentina,2210121,5.57,8441.92,211527,54036,1998594
17/3/21,Argentina,2218425,5.85,8441.92,215304,54231,2003121
18/3/21,Argentina,2226753,6.15,8441.92,216876,54386,2009877
19/3/21,Argentina,2234913,6.45,8441.92,218184,54476,2016729
20/3/21,Argentina,2241739,6.72,8441.92,218075,54517,2023664
21/3/21,Argentina,2245771,6.84,8441.92,215618,54545,2030153
22/3/21,Argentina,2252172,6.89,8441.92,214486,54671,2037686
23/3/21,Argentina,2261577,7.11,8441.92,217620,54823,2043957
24/3/21,Argentina,2269877,7.3,8441.92,220842,54946,2049035
25/3/21,Argentina,2278115,7.38,8441.92,221643,55092,2056472
26/3/21,Argentina,2291051,7.62,8441.92,226572,55235,2064479
27/3/21,Argentina,2301389,7.83,8441.92,229161,55368,2072228
28/3/21,Argentina,2308597,7.95,8441.92,229082,55449,2079515
29/3/21,Argentina,2322611,7.99,8441.92,234355,55611,2088256
30/3/21,Argentina,2332765,8.21,8441.92,236912,55736,2095853
31/3/21,Argentina,2348821,8.53,8441.92,246205,55858,2102616
1/4/21,Argentina,2363251,8.82,8441.92,250985,55941,2112266
2/4/21,Argentina,2373153,9.04,8441.92,251199,56023,2121954
3/4/21,Argentina,2383537,9.16,8441.92,252897,56106,2130640
4/4/21,Argentina,2393492,9.29,8441.92,253012,56199,2140480
5/4/21,Argentina,2407159,9.34,8441.92,253650,56471,2153509
6/4/21,Argentina,2428029,9.66,8441.92,263984,56634,2164045
7/4/21,Argentina,2450068,10.02,8441.92,275443,56832,2174625
8/4/21,Argentina,2473751,10.46,8441.92,284768,57122,2188983
9/4/21,Argentina,2497881,10.87,8441.92,293955,57350,2203926
10/4/21,Argentina,2517300,11.41,8441.92,299517,57647,2217783
11/4/21,Argentina,2532562,11.65,8441.92,299422,57779,2233140
12/4/21,Argentina,2551999,11.82,8441.92,304875,57957,2247124
13/4/21,Argentina,2579000,12.22,8441.92,316125,58174,2262875
14/4/21,Argentina,2604157,12.62,8441.92,325671,58542,2278486
15/4/21,Argentina,2629156,13.01,8441.92,328924,58925,2300232
16/4/21,Argentina,2658628,13.36,8441.92,334521,59084,2324107
17/4/21,Argentina,2677747,13.65,8441.92,333939,59164,2343808
18/4/21,Argentina,2694014,13.79,8441.92,329843,59228,2364171
19/4/21,Argentina,2714475,13.89,8441.92,328092,59476,2386383
20/4/21,Argentina,2743620,14.11,8441.92,335767,59792,2407853
21/4/21,Argentina,2769552,14.36,8441.92,344877,60083,2424675
22/4/21,Argentina,2796768,14.68,8441.92,346975,60620,2449793
23/4/21,Argentina,2824652,14.93,8441.92,350138,61176,2474514
24/4/21,Argentina,2845872,15.39,8441.92,349595,61474,2496277
25/4/21,Argentina,2860884,15.64,8441.92,342717,61644,2518167
26/4/21,Argentina,2879677,15.82,8441.92,337673,62087,2542004
27/4/21,Argentina,2905172,16.2,8441.92,341949,62599,2563223
28/4/21,Argentina,2928890,16.57,8441.92,346726,62947,2582164
29/4/21,Argentina,2954943,16.92,8441.92,346866,63508,2608077
30/4/21,Argentina,2977363,17.25,8441.92,343057,63865,2634306
1/5/21,Argentina,2993865,17.48,8441.92,338506,64096,2655359
2/5/21,Argentina,3005259,17.54,8441.92,329062,64252,2676197
3/5/21,Argentina,3021179,17.63,8441.92,323107,64792,2698072
4/5/21,Argentina,3047417,17.97,8441.92,329959,65202,2717458
5/5/21,Argentina,3071496,18.4,8441.92,337031,65865,2734465
6/5/21,Argentina,3095582,18.84,8441.92,338352,66263,2757230
7/5/21,Argentina,3118134,19.34,8441.92,340232,66872,2777902
8/5/21,Argentina,3136158,19.74,8441.92,337830,67042,2798328
9/5/21,Argentina,3147740,19.92,8441.92,330575,67325,2817165
10/5/21,Argentina,3165121,20,8441.92,328063,67821,2837058
11/5/21,Argentina,3191097,20.25,8441.92,336733,68311,2854364
12/5/21,Argentina,3215572,20.58,8441.92,346231,68807,2869341
13/5/21,Argentina,3242103,20.92,8441.92,350668,69254,2891435
14/5/21,Argentina,3269466,21.28,8441.92,356322,69853,2913144
15/5/21,Argentina,3290935,21.63,8441.92,356989,70253,2933946
16/5/21,Argentina,3307285,21.77,8441.92,354686,70522,2952599
17/5/21,Argentina,3335965,21.93,8441.92,362698,71027,2973267
18/5/21,Argentina,3371508,22.35,8441.92,379183,71771,2992325
19/5/21,Argentina,3411160,22.77,8441.92,402010,72265,3009150
20/5/21,Argentina,3447044,23.13,8441.92,411910,72699,3035134
21/5/21,Argentina,3482512,23.59,8441.92,422367,73391,3060145
22/5/21,Argentina,3514683,24.03,8441.92,431385,73688,3083298
23/5/21,Argentina,3539484,24.27,8441.92,432535,74063,3106949
24/5/21,Argentina,3562135,24.45,8441.92,428952,74480,3133183
25/5/21,Argentina,3586736,24.65,8441.92,429076,75056,3157660
26/5/21,Argentina,3622135,24.85,8441.92,440847,75588,3181288
27/5/21,Argentina,3663215,25.22,8441.92,443741,76135,3219474
28/5/21,Argentina,3702422,25.6,8441.92,449579,76693,3252843
29/5/21,Argentina,3732263,26.11,8441.92,443796,77108,3288467
30/5/21,Argentina,3753609,26.58,8441.92,434541,77456,3319068
31/5/21,Argentina,3781784,26.88,8441.92,431182,78093,3350602
1/6/21,Argentina,3817139,27.4,8441.92,435802,78733,3381337
2/6/21,Argentina,3852156,28.07,8441.92,442840,79320,3409316
3/6/21,Argentina,3884447,28.68,8441.92,446010,79873,3438437
4/6/21,Argentina,3915397,29.33,8441.92,450260,80411,3465137
5/6/21,Argentina,3939024,30.11,8441.92,441524,80867,3497500
6/6/21,Argentina,3955439,30.9,8441.92,426406,81214,3529033
7/6/21,Argentina,3977634,31.43,8441.92,417486,81946,3560148
8/6/21,Argentina,4008771,32.15,8441.92,422960,82667,3585811
9/6/21,Argentina,4038528,32.92,8441.92,429633,83272,3608895
10/6/21,Argentina,4066156,33.67,8441.92,426754,83941,3639402
11/6/21,Argentina,4093090,34.49,8441.92,424418,84628,3668672
12/6/21,Argentina,4111147,35.31,8441.92,415859,85075,3695288
13/6/21,Argentina,4124190,35.71,8441.92,402840,85343,3721350
14/6/21,Argentina,4145482,35.92,8441.92,396688,86029,3748794
15/6/21,Argentina,4172742,36.49,8441.92,400774,86615,3771968
16/6/21,Argentina,4198620,37.01,8441.92,406641,87261,3791979
17/6/21,Argentina,4222400,37.65,8441.92,404054,87789,3818346
18/6/21,Argentina,4242763,38.32,8441.92,398434,88247,3844329
19/6/21,Argentina,4258394,39.11,8441.92,390289,88742,3868105
20/6/21,Argentina,4268789,39.66,8441.92,378576,89043,3890213
21/6/21,Argentina,4277395,39.9,8441.92,366560,89490,3910835
22/6/21,Argentina,4298782,40.3,8441.92,370393,90281,3928389
23/6/21,Argentina,4326101,40.89,8441.92,381778,90986,3944323
24/6/21,Argentina,4350564,41.49,8441.92,382931,91438,3967633
25/6/21,Argentina,4374587,42.11,8441.92,384298,91979,3990289
26/6/21,Argentina,4393142,42.76,8441.92,382796,92317,4010346
27/6/21,Argentina,4405247,43.3,8441.92,377737,92568,4027510
28/6/21,Argentina,4423636,43.75,8441.92,377328,93142,4046308
29/6/21,Argentina,4447701,44.34,8441.92,385456,93668,4062245
30/6/21,Argentina,4470374,45.05,8441.92,393453,94304,4076921
1/2/21,Denmark,199644,4.58,60908.84,10999,2146,188645
2/2/21,Denmark,200041,4.66,60908.84,10488,2161,189553
3/2/21,Denmark,200466,4.79,60908.84,10016,2171,190450
4/2/21,Denmark,201020,5,60908.84,9791,2185,191229
5/2/21,Denmark,201458,5.24,60908.84,9377,2202,192081
6/2/21,Denmark,201871,5.37,60908.84,9085,2216,192786
7/2/21,Denmark,202307,5.46,60908.84,8930,2217,193377
8/2/21,Denmark,202737,5.62,60908.84,8853,2217,193884
9/2/21,Denmark,203104,5.76,60908.84,8505,2245,194599
10/2/21,Denmark,203574,5.88,60908.84,8291,2256,195283
11/2/21,Denmark,204052,6.02,60908.84,8246,2270,195806
12/2/21,Denmark,204480,6.35,60908.84,8172,2281,196308
13/2/21,Denmark,204754,6.48,60908.84,8044,2285,196710
14/2/21,Denmark,205049,6.6,60908.84,7982,2293,197067
15/2/21,Denmark,205486,6.88,60908.84,8037,2302,197449
16/2/21,Denmark,205871,7.12,60908.84,7929,2309,197942
17/2/21,Denmark,206285,7.31,60908.84,7855,2317,198430
18/2/21,Denmark,206753,7.5,60908.84,7890,2320,198863
19/2/21,Denmark,207305,7.76,60908.84,8002,2328,199303
20/2/21,Denmark,207769,7.94,60908.84,8058,2334,199711
21/2/21,Denmark,208265,8.13,60908.84,8131,2339,200134
22/2/21,Denmark,208715,8.37,60908.84,8212,2344,200503
23/2/21,Denmark,209244,8.65,60908.84,8296,2344,200948
24/2/21,Denmark,209767,8.91,60908.84,8366,2346,201401
25/2/21,Denmark,210370,9.17,60908.84,8530,2352,201840
26/2/21,Denmark,210900,9.8,60908.84,8682,2354,202218
27/2/21,Denmark,211420,9.94,60908.84,8885,2359,202535
28/2/21,Denmark,211883,10.14,60908.84,9015,2362,202868
1/3/21,Denmark,212380,10.49,60908.84,9176,2366,203204
2/3/21,Denmark,212912,10.8,60908.84,9311,2368,203601
3/3/21,Denmark,213486,11.04,60908.84,9366,2371,204120
4/3/21,Denmark,214007,11.37,60908.84,9386,2375,204621
5/3/21,Denmark,214621,11.75,60908.84,9451,2378,205170
6/3/21,Denmark,215015,12.06,60908.84,9392,2378,205623
7/3/21,Denmark,215528,12.34,60908.84,9476,2380,206052
8/3/21,Denmark,215955,12.61,60908.84,9436,2382,206519
9/3/21,Denmark,216482,12.91,60908.84,9373,2382,207109
10/3/21,Denmark,218489,13.24,60908.84,10362,2383,208127
11/3/21,Denmark,219351,13.45,60908.84,10643,2385,208708
12/3/21,Denmark,219996,13.68,60908.84,10707,2388,209289
13/3/21,Denmark,220609,13.86,60908.84,10788,2391,209821
14/3/21,Denmark,221151,14.04,60908.84,10861,2392,210290
15/3/21,Denmark,221763,14.25,60908.84,10961,2394,210802
16/3/21,Denmark,222534,14.53,60908.84,11118,2396,211416
17/3/21,Denmark,223321,14.86,60908.84,11277,2397,212044
18/3/21,Denmark,224107,15.24,60908.84,11457,2398,212650
19/3/21,Denmark,224950,15.57,60908.84,11680,2398,213270
20/3/21,Denmark,225540,15.7,60908.84,11677,2400,213863
21/3/21,Denmark,226197,15.86,60908.84,11806,2401,214391
22/3/21,Denmark,227469,16.07,60908.84,12490,2403,214979
23/3/21,Denmark,227723,16.3,60908.84,11997,2404,215726
24/3/21,Denmark,225722,16.69,60908.84,9261,2405,216461
25/3/21,Denmark,226536,16.97,60908.84,10075,2410,216461
26/3/21,Denmark,227325,17.21,60908.84,11038,2412,216287
27/3/21,Denmark,227741,17.43,60908.84,10924,2414,216817
28/3/21,Denmark,228705,17.66,60908.84,11424,2415,217281
29/3/21,Denmark,229384,18.07,60908.84,11622,2416,217762
30/3/21,Denmark,230594,18.55,60908.84,11657,2418,218937
31/3/21,Denmark,231295,18.93,60908.84,11619,2420,219676
1/4/21,Denmark,231957,19.12,60908.84,11571,2424,220386
2/4/21,Denmark,232665,19.33,60908.84,11620,2425,221045
3/4/21,Denmark,233410,19.57,60908.84,11715,2429,221695
4/4/21,Denmark,234010,19.8,60908.84,11729,2430,222281
5/4/21,Denmark,234489,20.04,60908.84,11646,2431,222843
6/4/21,Denmark,235009,20.41,60908.84,11306,2433,223703
7/4/21,Denmark,235623,20.84,60908.84,11108,2436,224515
8/4/21,Denmark,236340,21.22,60908.84,11041,2437,225299
9/4/21,Denmark,237038,21.65,60908.84,11092,2437,225946
10/4/21,Denmark,237793,22.03,60908.84,11134,2440,226659
11/4/21,Denmark,238484,22.35,60908.84,11163,2442,227321
12/4/21,Denmark,238998,24.16,60908.84,11063,2444,227935
13/4/21,Denmark,239561,24.59,60908.84,10863,2447,228698
14/4/21,Denmark,240225,24.97,60908.84,10849,2448,229376
15/4/21,Denmark,241023,25.39,60908.84,10960,2450,230063
16/4/21,Denmark,241700,25.83,60908.84,10925,2453,230775
17/4/21,Denmark,242424,26.2,60908.84,11095,2453,231329
18/4/21,Denmark,243326,26.54,60908.84,11469,2456,231857
19/4/21,Denmark,244067,27.21,60908.84,11748,2460,232319
20/4/21,Denmark,244759,27.88,60908.84,11877,2464,232882
21/4/21,Denmark,245562,28.48,60908.84,11972,2466,233590
22/4/21,Denmark,246455,29.06,60908.84,12150,2468,234305
23/4/21,Denmark,247157,29.63,60908.84,12125,2473,235032
24/4/21,Denmark,247704,30.02,60908.84,11947,2475,235757
25/4/21,Denmark,248316,30.37,60908.84,12002,2476,236314
26/4/21,Denmark,249020,31.05,60908.84,12169,2478,236851
27/4/21,Denmark,249644,31.86,60908.84,12027,2480,237617
28/4/21,Denmark,250479,32.63,60908.84,12034,2482,238445
29/4/21,Denmark,251248,33.38,60908.84,12798,2484,238450
30/4/21,Denmark,251249,33.68,60908.84,12799,2484,238450
1/5/21,Denmark,252740,33.91,60908.84,12134,2490,240606
2/5/21,Denmark,253607,34.43,60908.84,12345,2491,241262
3/5/21,Denmark,254368,35.57,60908.84,12396,2491,241972
4/5/21,Denmark,255178,36.47,60908.84,12326,2492,242852
5/5/21,Denmark,255181,37.43,60908.84,12329,2492,242852
6/5/21,Denmark,257181,38.24,60908.84,12770,2494,244411
7/5/21,Denmark,258204,38.95,60908.84,13147,2496,245057
8/5/21,Denmark,258881,39.64,60908.84,13190,2498,245691
9/5/21,Denmark,259755,40.81,60908.84,13500,2498,246255
10/5/21,Denmark,260687,41.87,60908.84,13825,2498,246862
11/5/21,Denmark,261613,42.83,60908.84,14017,2500,247596
12/5/21,Denmark,262859,43.75,60908.84,14310,2500,248549
13/5/21,Denmark,264214,44.43,60908.84,14837,2500,249377
14/5/21,Denmark,265165,45.31,60908.84,14984,2500,250181
15/5/21,Denmark,266240,45.91,60908.84,15289,2503,250951
16/5/21,Denmark,267204,46.49,60908.84,15559,2503,251645
17/5/21,Denmark,268040,47.53,60908.84,15677,2504,252363
18/5/21,Denmark,268956,48.58,60908.84,15572,2504,253384
19/5/21,Denmark,270047,49.51,60908.84,15670,2506,254377
20/5/21,Denmark,271261,49.86,60908.84,15823,2507,255438
21/5/21,Denmark,272613,50.52,60908.84,16290,2507,256323
22/5/21,Denmark,273366,52.04,60908.84,16131,2508,257235
23/5/21,Denmark,274204,52.53,60908.84,16117,2509,258087
24/5/21,Denmark,275139,53.1,60908.84,16255,2510,258884
25/5/21,Denmark,275935,54.06,60908.84,15922,2511,260013
26/5/21,Denmark,277011,55.09,60908.84,15665,2512,261346
27/5/21,Denmark,278136,56.14,60908.84,15590,2512,262546
28/5/21,Denmark,279139,57.01,60908.84,15689,2513,263450
29/5/21,Denmark,280183,57.32,60908.84,15863,2517,264320
30/5/21,Denmark,281141,57.61,60908.84,15877,2517,265264
31/5/21,Denmark,281985,59.15,60908.84,15803,2517,266182
1/6/21,Denmark,282896,60.12,60908.84,15562,2517,267334
2/6/21,Denmark,283852,61.14,60908.84,15334,2517,268518
3/6/21,Denmark,284888,62.14,60908.84,15229,2518,269659
4/6/21,Denmark,285823,62.59,60908.84,15142,2518,270681
5/6/21,Denmark,286420,63.05,60908.84,14911,2519,271509
6/6/21,Denmark,287275,64.49,60908.84,14976,2519,272299
7/6/21,Denmark,287735,65.73,60908.84,14631,2521,273104
8/6/21,Denmark,288115,67.03,60908.84,14131,2521,273984
9/6/21,Denmark,289024,68.33,60908.84,13945,2521,275079
10/6/21,Denmark,289501,69.59,60908.84,13223,2523,276278
11/6/21,Denmark,289919,70.68,60908.84,12648,2524,277271
12/6/21,Denmark,290358,71.08,60908.84,12151,2526,278207
13/6/21,Denmark,290674,71.44,60908.84,11651,2526,279023
14/6/21,Denmark,290912,73.41,60908.84,11073,2527,279839
15/6/21,Denmark,291139,74.74,60908.84,10287,2528,280852
16/6/21,Denmark,291492,75.47,60908.84,9518,2528,281974
17/6/21,Denmark,291824,76.17,60908.84,8921,2529,282903
18/6/21,Denmark,292029,77.21,60908.84,8367,2529,283662
19/6/21,Denmark,292273,78.34,60908.84,7891,2531,284382
20/6/21,Denmark,292467,79.33,60908.84,7461,2531,285006
21/6/21,Denmark,292618,80.91,60908.84,7071,2532,285547
22/6/21,Denmark,292775,82.16,60908.84,6605,2532,286170
23/6/21,Denmark,292999,83.37,60908.84,6312,2532,286687
24/6/21,Denmark,293172,84.53,60908.84,6010,2532,287162
25/6/21,Denmark,293394,85.59,60908.84,5810,2532,287584
26/6/21,Denmark,293590,86.3,60908.84,5692,2532,287898
27/6/21,Denmark,293765,86.99,60908.84,5623,2533,288142
28/6/21,Denmark,293916,88.08,60908.84,5548,2534,288368
29/6/21,Denmark,294162,89.33,60908.84,5478,2535,288684
30/6/21,Denmark,294503,90.55,60908.84,5503,2535,289000
1/2/21,Netherlands,995300,2.25,52304.06,982326,14135,12974
2/2/21,Netherlands,998924,2.46,52304.06,985878,14218,13046
3/2/21,Netherlands,1003010,2.65,52304.06,989907,14281,13103
4/2/21,Netherlands,1007268,2.85,52304.06,994112,14346,13156
5/2/21,Netherlands,1011636,3.04,52304.06,998418,14407,13218
6/2/21,Netherlands,1015757,3.2,52304.06,1002471,14468,13286
7/2/21,Netherlands,1019720,3.34,52304.06,1006391,14516,13329
8/2/21,Netherlands,1021966,3.53,52304.06,1008572,14543,13394
9/2/21,Netherlands,1023779,3.72,52304.06,1010335,14629,13444
10/2/21,Netherlands,1027023,3.91,52304.06,1013546,14710,13477
11/2/21,Netherlands,1031454,4.09,52304.06,1017886,14782,13568
12/2/21,Netherlands,1035841,4.28,52304.06,1022215,14847,13626
13/2/21,Netherlands,1040070,4.45,52304.06,1026375,14913,13695
14/2/21,Netherlands,1043541,4.61,52304.06,1029813,14936,13728
15/2/21,Netherlands,1046381,4.8,52304.06,1032616,14963,13765
16/2/21,Netherlands,1049120,4.98,52304.06,1035311,15050,13809
17/2/21,Netherlands,1052544,5.19,52304.06,1038696,15138,13848
18/2/21,Netherlands,1057116,5.4,52304.06,1043203,15211,13913
19/2/21,Netherlands,1061903,5.63,52304.06,1047929,15261,13974
20/2/21,Netherlands,1066522,5.85,52304.06,1052493,15323,14029
21/2/21,Netherlands,1071223,6.07,52304.06,1057162,15340,14061
22/2/21,Netherlands,1075425,6.29,52304.06,1061308,15372,14117
23/2/21,Netherlands,1079272,6.55,52304.06,1065124,15466,14148
24/2/21,Netherlands,1083686,6.84,52304.06,1069467,15529,14219
25/2/21,Netherlands,1088730,7.15,52304.06,1074444,15561,14286
26/2/21,Netherlands,1093899,7.49,52304.06,1079569,15626,14330
27/2/21,Netherlands,1098875,7.8,52304.06,1084497,15668,14378
28/2/21,Netherlands,1103564,8.09,52304.06,1089148,15688,14416
1/3/21,Netherlands,1107347,8.35,52304.06,1092863,15710,14484
2/3/21,Netherlands,1111364,8.62,52304.06,1096831,15775,14533
3/3/21,Netherlands,1116404,8.88,52304.06,1101824,15824,14580
4/3/21,Netherlands,1120566,9.14,52304.06,1105980,15857,14586
5/3/21,Netherlands,1125299,9.39,52304.06,1110635,15890,14664
6/3/21,Netherlands,1130694,9.61,52304.06,1116007,15931,14687
7/3/21,Netherlands,1135258,9.81,52304.06,1120552,15962,14706
8/3/21,Netherlands,1139102,10.05,52304.06,1124389,15990,14713
9/3/21,Netherlands,1143481,10.29,52304.06,1128695,16046,14786
10/3/21,Netherlands,1148836,10.54,52304.06,1134007,16077,14829
11/3/21,Netherlands,1154257,10.78,52304.06,1139380,16127,14877
12/3/21,Netherlands,1160380,11.01,52304.06,1145452,16153,14928
13/3/21,Netherlands,1166923,11.25,52304.06,1151969,16176,14954
14/3/21,Netherlands,1172975,11.48,52304.06,1157994,16200,14981
15/3/21,Netherlands,1178501,11.65,52304.06,1163480,16218,15021
16/3/21,Netherlands,1183567,11.83,52304.06,1168512,16251,15055
17/3/21,Netherlands,1189707,12.01,52304.06,1174586,16298,15121
18/3/21,Netherlands,1196045,12.19,52304.06,1180889,16332,15156
19/3/21,Netherlands,1203622,12.37,52304.06,1188426,16379,15196
20/3/21,Netherlands,1211447,12.55,52304.06,1196174,16395,15273
21/3/21,Netherlands,1218610,12.72,52304.06,1203298,16411,15312
22/3/21,Netherlands,1224947,12.9,52304.06,1209560,16426,15387
23/3/21,Netherlands,1230746,13.1,52304.06,1215305,16475,15441
24/3/21,Netherlands,1238664,13.37,52304.06,1223134,16510,15530
25/3/21,Netherlands,1246682,13.64,52304.06,1231086,16536,15596
26/3/21,Netherlands,1254722,13.91,52304.06,1239069,16561,15653
27/3/21,Netherlands,1263882,14.19,52304.06,1248103,16592,15779
28/3/21,Netherlands,1271580,14.46,52304.06,1255673,16607,15907
29/3/21,Netherlands,1278519,14.83,52304.06,1262499,16620,16020
30/3/21,Netherlands,1284585,15.22,52304.06,1268483,16657,16102
31/3/21,Netherlands,1292806,15.65,52304.06,1276597,16689,16209
1/4/21,Netherlands,1301127,16.07,52304.06,1284821,16713,16306
2/4/21,Netherlands,1308774,16.51,52304.06,1292328,16733,16446
3/4/21,Netherlands,1316913,16.81,52304.06,1300351,16766,16562
4/4/21,Netherlands,1324021,17.09,52304.06,1307286,16790,16735
5/4/21,Netherlands,1329560,17.42,52304.06,1312719,16801,16841
6/4/21,Netherlands,1335312,17.9,52304.06,1318326,16826,16986
7/4/21,Netherlands,1341742,18.45,52304.06,1324707,16850,17035
8/4/21,Netherlands,1350034,19.04,52304.06,1332601,16873,17433
9/4/21,Netherlands,1358016,19.66,52304.06,1340316,16915,17700
10/4/21,Netherlands,1366024,20.26,52304.06,1347970,16939,18054
11/4/21,Netherlands,1374451,20.85,52304.06,1356221,16959,18230
12/4/21,Netherlands,1381182,21.55,52304.06,1362571,16981,18611
13/4/21,Netherlands,1387961,22.25,52304.06,1368953,17018,19008
14/4/21,Netherlands,1393543,22.95,52304.06,1373991,17048,19552
15/4/21,Netherlands,1402433,23.64,52304.06,1382525,17063,19908
16/4/21,Netherlands,1411474,24.3,52304.06,1391248,17080,20226
17/4/21,Netherlands,1419871,24.95,52304.06,1398811,17114,21060
18/4/21,Netherlands,1428440,25.58,52304.06,1407058,17127,21382
19/4/21,Netherlands,1435601,26.22,52304.06,1413943,17150,21658
20/4/21,Netherlands,1442481,26.85,52304.06,1420751,17179,21730
21/4/21,Netherlands,1451071,27.41,52304.06,1428932,17202,22139
22/4/21,Netherlands,1460753,27.92,52304.06,1438371,17226,22382
23/4/21,Netherlands,1470037,28.43,52304.06,1447323,17245,22714
24/4/21,Netherlands,1478144,28.94,52304.06,1455174,17269,22970
25/4/21,Netherlands,1486205,29.45,52304.06,1462880,17281,23325
26/4/21,Netherlands,1492437,30.02,52304.06,1468949,17295,23488
27/4/21,Netherlands,1497806,30.59,52304.06,1473861,17328,23945
28/4/21,Netherlands,1506476,31.14,52304.06,1482475,17339,24001
29/4/21,Netherlands,1515165,31.73,52304.06,1489637,17372,25528
30/4/21,Netherlands,1522973,32.31,52304.06,1497341,17398,25632
1/5/21,Netherlands,1528753,32.94,52304.06,1502969,17421,25784
2/5/21,Netherlands,1534264,33.52,52304.06,1508434,17425,25830
3/5/21,Netherlands,1543494,34.16,52304.06,1517554,17443,25940
4/5/21,Netherlands,1551248,34.77,52304.06,1525244,17475,26004
5/5/21,Netherlands,1558549,35.49,52304.06,1532478,17501,26071
6/5/21,Netherlands,1565352,36.21,52304.06,1539226,17525,26126
7/5/21,Netherlands,1572861,36.95,52304.06,1546697,17547,26164
8/5/21,Netherlands,1580300,37.68,52304.06,1554055,17578,26245
9/5/21,Netherlands,1586868,38.37,52304.06,1560591,17582,26277
10/5/21,Netherlands,1592742,39.12,52304.06,1566432,17602,26310
11/5/21,Netherlands,1598280,39.91,52304.06,1571936,17648,26344
12/5/21,Netherlands,1604659,40.81,52304.06,1578279,17664,26380
13/5/21,Netherlands,1610699,41.68,52304.06,1584248,17679,26451
14/5/21,Netherlands,1616234,42.5,52304.06,1589757,17690,26477
15/5/21,Netherlands,1620702,43.37,52304.06,1594207,17703,26495
16/5/21,Netherlands,1625151,44.2,52304.06,1598634,17717,26517
17/5/21,Netherlands,1627997,45.1,52304.06,1601463,17725,26534
18/5/21,Netherlands,1633356,46,52304.06,1606794,17742,26562
19/5/21,Netherlands,1637940,46.86,52304.06,1611350,17758,26590
20/5/21,Netherlands,1642610,47.7,52304.06,1615999,17778,26611
21/5/21,Netherlands,1646781,48.54,52304.06,1620148,17790,26633
22/5/21,Netherlands,1649960,49.36,52304.06,1623315,17810,26645
23/5/21,Netherlands,1653395,50.17,52304.06,1626742,17817,26653
24/5/21,Netherlands,1656090,50.68,52304.06,1629434,17827,26656
25/5/21,Netherlands,1658587,51.27,52304.06,1631883,17840,26704
26/5/21,Netherlands,1661364,52.43,52304.06,1634636,17850,26728
27/5/21,Netherlands,1664708,53.21,52304.06,1637954,17866,26754
28/5/21,Netherlands,1668581,54.13,52304.06,1641801,17881,26780
29/5/21,Netherlands,1671967,55.06,52304.06,1645157,17889,26810
30/5/21,Netherlands,1674694,55.95,52304.06,1647869,17895,26825
31/5/21,Netherlands,1676744,56.87,52304.06,1649905,17897,26839
1/6/21,Netherlands,1679093,57.84,52304.06,1652212,17906,26881
2/6/21,Netherlands,1681609,58.81,52304.06,1654722,17918,26887
3/6/21,Netherlands,1684374,59.82,52304.06,1657458,17932,26916
4/6/21,Netherlands,1686778,60.78,52304.06,1659846,17940,26932
5/6/21,Netherlands,1688925,61.74,52304.06,1661966,17950,26959
6/6/21,Netherlands,1690481,62.74,52304.06,1663510,17954,26971
7/6/21,Netherlands,1691866,63.52,52304.06,1664885,17957,26981
8/6/21,Netherlands,1693302,64.9,52304.06,1666284,17972,27018
9/6/21,Netherlands,1695034,66.36,52304.06,1667987,17977,27047
10/6/21,Netherlands,1696609,67.78,52304.06,1669534,17983,27075
11/6/21,Netherlands,1697999,69.17,52304.06,1670897,17986,27102
12/6/21,Netherlands,1699213,71.09,52304.06,1672105,17987,27108
13/6/21,Netherlands,1700260,72.45,52304.06,1673150,17989,27110
14/6/21,Netherlands,1701124,73.67,52304.06,1673994,17993,27130
15/6/21,Netherlands,1702174,74.9,52304.06,1675031,17994,27143
16/6/21,Netherlands,1703218,76.09,52304.06,1676066,17998,27152
17/6/21,Netherlands,1704305,77.27,52304.06,1677134,18001,27171
18/6/21,Netherlands,1705206,78.45,52304.06,1678024,18004,27182
19/6/21,Netherlands,1705905,79.64,52304.06,1678703,18007,27202
20/6/21,Netherlands,1706611,80.8,52304.06,1679402,18007,27209
21/6/21,Netherlands,1707181,81.96,52304.06,1679956,18008,27225
22/6/21,Netherlands,1707881,83.13,52304.06,1680640,18011,27241
23/6/21,Netherlands,1708539,84.3,52304.06,1681286,18015,27253
24/6/21,Netherlands,1709261,85.49,52304.06,1681994,18018,27267
25/6/21,Netherlands,1709911,86.74,52304.06,1682631,18023,27280
26/6/21,Netherlands,1710474,88.05,52304.06,1683184,18023,27290
27/6/21,Netherlands,1710973,89.34,52304.06,1683683,18024,27290
28/6/21,Netherlands,1711545,90.57,52304.06,1684222,18024,27323
29/6/21,Netherlands,1712100,91.8,52304.06,1684763,18028,27337
30/6/21,Netherlands,1712747,93.02,52304.06,1685397,18028,27350